deutsch=>Gattung Art
Engelsschnäutze=>Gattung Art
Zunderschwamm=>Nostoc commune
Schuppiger Porling=>Fomes fomentarius
Kriechender Günsel=>Polyporus squamosus
Goldtaler=>Ajuga reptans
Bunte Bellardie=>Asteriscus maritimus
Besenheide=>Bellardia trixago
Mauer-Zimbelkraut=>Calluna vulgaris
Feinstrahl, Einjähriges Berufkraut=>Cymbalaria muralis
Riesenfenchel=>Erigeron annuus
Hohe Schlüsselblume=>Ferula communis
Heidelbeere=>Primula elatior
Großer Ehrenpreis=>Vaccinium myrtillus
Persischer Ehrenpreis=>Veronica austriaca
Guter Heinrich=>Veronica persica
Rosen-Lauch=>Chenopodium bonus-henricus
Bärlauch=>Allium roseum
Stacheliger Dornginster=>Allium ursinum
Behaarter Backenklee=>Callicotome spinosa
Mandelblättrige Wolfsmilch=>Dorycnium hirsutum
Wald-Storchschnabel=>Euphorbia amygdaloides
Wohlriechendes Veilchen, Märzveilchen=>Geranium sylvaticum
Rundblättriger Steinbrech=>Viola odorata
Gewöhnliche Strandsimse=>Saxifraga rotundifolia
Hirschzunge=>Bolboschoenus maritimus
Gewöhnlicher Adlerfarn=>Asplenium scolopendrium
Rot-Fichte=>Pteridium aquilinum
Schwarzkiefer=>Picea abies
Amethyst-Lacktrichterling=>Pinus nigra
Mönchskopf=>Laccaria amethystina
Fichtenporling=>Clitocybe geotropa
Orangefarbiger Neststäubling=>Fomitopsis pinicola
Filzige Hundskamille=>Trichia scabra
Große Klette=>Anthemis tomentosa
Gewöhnliches Gänseblümchen=>Arctium lappa
Gewöhnliche Wegwarte=>Bellis perennis
Roter Fingerhut=>Cichorium intybus
Drüsenblättrige Kugeldistel=>Digitalis purpurea
Stranddistel=>Echinops sphaerocephalus
Zwergedelweiss=>Eryngium maritimum
Forsythie, Goldflieder=>Evax pygmaea
Gewöhnliche Esche=>Forsythia suspensa
Efeu-Gundermann=>Fraxinus excelsior
Gewöhnliche Goldnessel=>Glechoma hederacea
Schopf-Lavendel=>Lamium galeobdolon
Sumpf-Vergissmeinnicht=>Lavandula stoechas
Gewöhnlicher Löwenzahn=>Myosotis scorpioides
Huflattich=>Taraxacum officinale agg.
Schwarze Königskerze=>Tussilago farfara
Schwalbenwurz=>Verbascum nigrum
Weiß-Tanne=>Vincetoxicum hirundinaria
Küsten-Tanne=>Abies alba
Nordmanns-Tanne=>Abies grandis
Edel-Tanne=>Abies nordmanniana
Chinesische Samtpappel=>Abies procera
Feld-Ahorn=>Abutilon theophrasti
Feuer-Ahorn=>Acer campestre
Französischer Ahorn=>Acer ginnala
Eschen-Ahorn=>Acer monspessulanum
Spitz-Ahorn=>Acer negundo
Berg-Ahorn=>Acer platanoides
Rot-Ahorn=>Acer pseudoplatanus
Silber-Ahorn=>Acer rubrum
Zucker-Ahorn=>Acer saccharinum
Tataren-Ahorn=>Acer saccharum
Ohnsporn=>Acer tataricum
Schwarzrandige Schafgarbe=>Aceras anthropophorum
Bittere Schafgarbe=>Achillea atrata
Meerfenchelblättrige Schafgarbe=>Achillea clavennae
Goldgarbe=>Achillea crithmifolia
Großblättrige Schafgarbe=>Achillea filipendulina
Hügel-Wiesen-Schafgarbe=>Achillea macrophylla
Zahnblatt-Wiesen-Schafgarbe=>Achillea collina
Gewöhnliche Wiesen-Schafgarbe=>Achillea distans
Ungarische Wiesen-Schafgarbe=>Achillea millefolium
Rasige Wiesen-Schafgarbe=>Achillea pannonica
Blassrote Wiesen-Schafgarbe=>Achillea pratensis
Edel-Schafgarbe=>Achillea roseoalba
Sumpf-Schafgarbe=>Achillea nobilis
Alpen-Steinquendel=>Achillea ptarmica
Feld-Steinquendel=>Acinos alpinus
Rispen-Eisenhut=>Acinos arvensis
Gelber Eisenhut=>Aconitum degenii
Blauer Eisenhut=>Aconitum lycoctonum
Rauhstieliger Eisenhut=>Aconitum napellus
Klaffender Eisenhut=>Aconitum pilipes
Tauern-Eisenhut=>Aconitum plicatum
Bunter Eisenhut=>Aconitum tauricum
Himalaja-Bergknöterich=>Aconitum variegatum
Indischer Kalmus=>Aconogonon polystachyum
Schwarzfrüchtiges Christophskraut=>Acorus calamus
Lilienblättrige Becherglocke=>Actaea spicata
Grauer Alpendost=>Adenophora liliifolia
Grüner Alpendost=>Adenostyles alliariae
Frauenhaarfarn=>Adenostyles glabra
Sommer-Adonisröschen=>Adiantum capillus-veneris
Herbst-Adonisröschen=>Adonis aestivalis
Flammen-Adonisröschen=>Adonis annua
Frühlings-Adonisröschen=>Adonis flammea
Europäisches Moschuskraut=>Adonis vernalis
Walzenförmiger Walch=>Adoxa moschatellina
Geknieter Walch=>Aegilops cylindrica
Giersch=>Aegilops geniculata
Gelbe Pavie=>Aegopodium podagraria
Gewöhnliche Rosskastanie=>Aesculus flava
Strauchkastanie=>Aesculus hippocastanum
Fünfblütige Kastanie=>Aesculus parviflora
Felsen-Steintäschel=>Aesculus quinqueflora
Hundspetersilie=>Aethionema saxatile
Leberbalsam=>Aethusa cynapium
Kleiner Odermennig=>Ageratum houstonianum
Großer Odermennig=>Agrimonia eupatoria
Armenischer Odermennig=>Agrimonia procera
Kamm-Quecke=>Agrimonia repens
Gewöhnliche Kornrade=>Agropyron cristatum
Zartes Straußgras=>Agrostemma githago
Alpen-Straußgras=>Agrostis agrostiflora
Pyrenäen-Straußgras=>Agrostis alpina
Sumpf-Straußgras=>Agrostis schleicheri
Sand-Straußgras=>Agrostis canina
Rotes Straußgras=>Agrostis vinealis
Kastilisches Straußgras=>Agrostis capillaris
Felsen-Straußgras=>Agrostis castellana
Rauhes Straußgras=>Agrostis rupestris
Riesen-Straußgras=>Agrostis scabra
Weißes Straußgras=>Agrostis gigantea
Chinesischer Götterbaum=>Agrostis stolonifera
Nelken-Haferschmiele=>Ailanthus altissima
Frühe Haferschmiele=>Aira caryophyllea
Gelber Günsel=>Aira praecox
Genfer Günsel=>Ajuga chamaepitys
Pyramiden-Günsel=>Ajuga genevensis
Seidenbaum=>Ajuga pyramidalis
Stockrose=>Albizia julibrissin
Alpen-Frauenmantel=>Alcea rosea
Kalkalpen-Frauenmantel=>Alchemilla alpina
Grobzähniger Frauenmantel=>Alchemilla alpigena
Hoppes Frauenmantel=>Alchemilla grossidens
Glänzender Frauenmantel=>Alchemilla hoppeana
Bleicher Frauenmantel=>Alchemilla nitida
Täuschender Frauenmantel=>Alchemilla pallens
Zerschlitzter Frauenmantel=>Alchemilla fallax
Eingeschnittener Frauenmantel=>Alchemilla fissa
Othmars Frauenmantel=>Alchemilla incisa
Seidennerviger Frauenmantel=>Alchemilla othmarii
Krain-Frauenmantel=>Alchemilla sericoneura
Geröteter Frauenmantel=>Alchemilla carniolica
Kleiner Frauenmantel=>Alchemilla colorata
Fächer-Frauenmantel=>Alchemilla exigua
Bastard-Frauenmantel=>Alchemilla flabellata
Gefalteter Frauenmantel=>Alchemilla glaucescens
Weicher Frauenmantel=>Alchemilla plicata
Kerners Frauenmantel=>Alchemilla mollis
Schimmernder Frauenmantel=>Alchemilla kerneri
Kleinknäuel-Frauenmantel=>Alchemilla splendens
Allgäu-Frauenmantel=>Alchemilla aggregata
Zusammenneigender Frauenmantel=>Alchemilla cleistophylla
Ledriger Frauenmantel=>Alchemilla connivens
Langhaariger Frauenmantel=>Alchemilla coriacea
Niederliegender Frauenmantel=>Alchemilla crinita
Ausgebreiteter Frauenmantel=>Alchemilla decumbens
Fadenstängel-Frauenmantel=>Alchemilla effusa
Behaarter Fadenstängel-Frauenmantel=>Alchemilla filicaulis
Kahler Frauenmantel=>Alchemilla vestita
Kahlstieliger Frauenmantel=>Alchemilla glabra
Knäueliger Frauenmantel=>Alchemilla glabricaulis
Westtiroler Frauenmantel=>Alchemilla glomerulans
Ungekämmter Frauenmantel=>Alchemilla hirtipes
Streifen-Frauenmantel=>Alchemilla impexa
Mond-Frauenmantel=>Alchemilla lineata
Zierlicher Frauenmantel=>Alchemilla lunaria
Bergwiesen-Frauenmantel=>Alchemilla micans
Stumpfer Frauenmantel=>Alchemilla monticola
Nierenblättriger Frauenmantel=>Alchemilla obtusa
Rotscheidiger Frauenmantel=>Alchemilla reniformis
Halbgeteilt-Frauenmantel=>Alchemilla rubristipula
Strohgelber Frauenmantel=>Alchemilla semisecta
Gestriegelter Frauenmantel=>Alchemilla straminea
Stumpfzähniger Frauenmantel=>Alchemilla strigosula
Kugeliger Frauenmantel=>Alchemilla subcrenata
Dünner Frauenmantel=>Alchemilla subglobosa
Tiroler Frauenmantel=>Alchemilla tenuis
Welliger Frauenmantel=>Alchemilla tirolensis
Wechselhaariger Frauenmantel=>Alchemilla undulata
Spitzlappiger Frauenmantel=>Alchemilla versipila
Gelbgrüner Frauenmantel=>Alchemilla vulgaris
Wasserfalle=>Alchemilla xanthochlora
Grasblättriger Froschlöffel=>Aldrovanda vesiculosa
Lanzettblättriger Froschlöffel=>Alisma gramineum
Gewöhnlicher Froschlöffel=>Alisma lanceolatum
Gewöhnliche Knoblauchsrauke=>Alisma plantago-aquatica
Kantiger Lauch=>Alliaria petiolata
Gekielter Lauch=>Allium angulosum
Küchenzwiebel=>Allium carinatum
Röhrenzwiebel=>Allium cepa
Gelber Lauch=>Allium fistulosum
Gold-Lauch=>Allium flavum
Gemüse-Lauch=>Allium moly
Rosen-Zwerg-Lauch=>Allium oleraceum
Wunder-Lauch=>Allium oreophilum
Porree=>Allium paradoxum
Knoblauch=>Allium porrum
Schnitt-Lauch=>Allium sativum
Schlangen-Lauch=>Allium schoenoprasum
Berg-Lauch=>Allium scorodoprasum
Kugelköpfiger Lauch=>Allium senescens
Wohlriechender Lauch=>Allium sphaerocephalon
Allermannsharnisch=>Allium suaveolens
Weinbergs-Lauch=>Allium victorialis
Grün-Erle=>Allium vineale
Herzblättrige Erle=>Alnus alnobetula
Schwarz-Erle=>Alnus cordata
Grau-Erle=>Alnus glutinosa
Rotgelbes Fuchsschwanzgras=>Alnus incana
Knick-Fuchsschwanzgras=>Alopecurus aequalis
Acker-Fuchsschwanzgras=>Alopecurus geniculatus
Rohr-Fuchsschwanzgras=>Alopecurus myosuroides
Wiesen-Fuchsschwanzgras=>Alopecurus arundinaceus
Aufgeblasenes Fuchsschwanzgras=>Alopecurus pratensis
Hanfblättriger Eibisch=>Alopecurus rendlei
Rauher Eibisch=>Althaea cannabina
Echter Eibisch=>Althaea hirsuta
Kelch-Steinkraut=>Althaea officinalis
Silbergraues Steinkraut=>Alyssum alyssoides
Berg-Steinkraut=>Alyssum argenteum
Silbriges Steinkraut=>Alyssum montanum
Kleines Steinkraut=>Alyssum murale
Weißer Fuchsschwanz=>Alyssum simplex
Westamerikanischer Fuchsschwanz=>Amaranthus albus
Aufsteigender Fuchsschwanz=>Amaranthus blitoides
Amarant=>Amaranthus blitum
Krauser Fuchsschwanz=>Amaranthus caudatus
Standleys Fuchsschwanz=>Amaranthus crispus
Liegender Fuchsschwanz=>Amaranthus standleyanus
Zweifelhafter Fuchsschwanz=>Amaranthus deflexus
Griechischer Fuchsschwanz=>Amaranthus dubius
Bouchons Fuchsschwanz=>Amaranthus graecizans
Rispiger Fuchsschwanz=>Amaranthus bouchonii
Ausgebreiteter Fuchsschwanz=>Amaranthus cruentus
Trauer-Fuchsschwanz=>Amaranthus hybridus
Grünähriger Fuchsschwanz=>Amaranthus hypochondriacus
Palmers Fuchsschwanz=>Amaranthus powellii
Zurückgekrümmter Fuchsschwanz=>Amaranthus palmeri
Dorniger Fuchsschwanz=>Amaranthus retroflexus
Thunbergs Fuchsschwanz=>Amaranthus spinosus
Beifußblättriges Traubenkraut=>Amaranthus thunbergii
Ausdauerndes Traubenkraut=>Ambrosia artemisiifolia
Dreilappiges Traubenkraut=>Ambrosia coronopifolia
Kahle Felsenbirne=>Ambrosia trifida
Kupfer-Felsenbirne=>Amelanchier laevis
Echte Felsenbirne=>Amelanchier lamarckii
Besen-Felsenbirne=>Amelanchier ovalis
Große Knorpelmöhre=>Amelanchier spicata
Bischofskraut=>Ammi majus
Strandhafer=>Ammi visnaga
Scheinindigo=>Ammophila arenaria
Gelbe Klette=>Amorpha fruticosa
Menzies Amsinckie=>Amsinckia lycopsoides
Pyramidenorchis=>Amsinckia menziesii
Acker-Gauchheil=>Anacamptis pyramidalis
Blauer Gauchheil=>Anagallis arvensis
Zwerg-Gauchheil=>Anagallis foemina
Großblütiges Perlkörbchen=>Anagallis minima
Lochschlund=>Anaphalis margaritacea
Acker-Krummhals=>Anarrhinum bellidifolium
Italienische Ochsenzunge=>Anchusa arvensis
Gewöhnliche Ochsenzunge=>Anchusa azurea
Rosmarinheide=>Anchusa officinalis
Bewimperter Mannsschild=>Andromeda polifolia
Langgestielter Mannsschild=>Androsace chamaejasme
Dolomiten-Mannsschild=>Androsace elongata
Schweizer Mannsschild=>Androsace hausmannii
Milchweißer Mannsschild=>Androsace helvetica
Stumpfblättriger Mannsschild=>Androsace lactea
Nördlicher Mannsschild=>Androsace obtusifolia
Apennin-Windröschen=>Androsace septentrionalis
Strahlenanemone=>Anemone apennina
Berghähnlein, Narzissenblütiges Windröschen=>Anemone blanda
Busch-Windröschen=>Anemone narcissiflora
Gelbes Windröschen=>Anemone nemorosa
Großes Windröschen=>Anemone ranunculoides
Echter Dill=>Anemone sylvestris
Arznei-Engelwurz=>Anethum graveolens
Wald-Engelwurz=>Angelica archangelica
Kapmalve=>Angelica sylvestris
Karpaten-Katzenpfötchen=>Anisodontea capensis
Gewöhnliches Katzenpfötchen=>Antennaria carpatica
Acker-Hundskamille=>Antennaria dioica
Österreichische Hundskamille=>Anthemis arvensis
Stinkende Hundskamille=>Anthemis austriaca
Durchscheinende Hundskamille=>Anthemis cotula
Ruthenische Hundskamille=>Anthemis hyalina
Färber-Hundskamille=>Anthemis ruthenica
Traubige Graslilie=>Anthemis tinctoria
Rispige Graslilie=>Anthericum liliago
Grannen-Ruchgras=>Anthericum ramosum
Alpen-Ruchgras=>Anthoxanthum aristatum
Gewöhnliches Ruchgras=>Anthoxanthum alpinum
Hunds-Kerbel=>Anthoxanthum odoratum
Garten-Kerbel=>Anthriscus caucalis
Glanz-Kerbel=>Anthriscus cerefolium
Wiesen-Kerbel=>Anthriscus nitida
Echter Wundklee=>Anthriscus sylvestris
Großes Löwenmaul=>Anthyllis vulneraria
Unterbrochener Windhalm=>Antirrhinum majus
Acker-Windhalm=>Apera interrupta
Gewöhnlicher Ackerfrauenmantel=>Apera spica-venti
Kleinfrüchtiger Ackerfrauenmantel=>Aphanes arvensis
Erdbirne=>Aphanes australis
Echter Sellerie=>Apios americana
Kriechender Sellerie=>Apium graveolens
Stinkender Hainsalat=>Apium repens
Kleinblütige Akelei=>Aposeris foetida
Schwarzviolette Akelei=>Aquilegia einseleana
Gewöhnliche Akelei=>Aquilegia atrata
Acker-Schmalwand=>Aquilegia vulgaris
Alpen-Gänsekresse=>Arabidopsis thaliana
Kaukasische Gänsekresse=>Arabis alpina
Öhrchen-Gänsekresse=>Arabis caucasica
Zwerg-Gänsekresse=>Arabis auriculata
Blaue Gänsekresse=>Arabis bellidifolia
Doldige Gänsekresse=>Arabis caerulea
Hügel-Gänsekresse=>Arabis ciliata
Turmkraut, Kahle Gänsekresse=>Arabis collina
Behaarte Gänsekresse=>Arabis glabra
Flachschotige Gänsekresse=>Arabis hirsuta
Pfeilblättrige Gänsekresse=>Arabis nemorensis
Armblütige Gänsekresse=>Arabis sagittata
Ungarische Gänsekresse=>Arabis pauciflora
Glänzende Gänsekresse=>Arabis procurrens
Turm-Gänsekresse=>Arabis soyeri
Kleine Klette=>Arabis turrita
Hain-Klette=>Arctium minus
Filzige Klette=>Arctium nemorosum
Alpen-Bärentraube=>Arctium tomentosum
Immergrüne Bärentraube=>Arctostaphylos alpinus
Nelkenwurz-Odermennig=>Arctostaphylos uva-ursi
Wimper-Sandkraut=>Aremonia agrimonoides
Dünnstängeliges Sandkraut=>Arenaria ciliata
Quendelblättriges Sandkraut=>Arenaria leptoclados
Gewöhnliche Osterluzei=>Arenaria serpyllifolia
Gewöhnliche Grasnelke=>Aristolochia clematitis
Gewöhnlicher Meerrettich=>Armeria maritima
Berg-Wohlverleih=>Armoracia rusticana
Lämmersalat=>Arnica montana
Glatthafer=>Arnoseris minima
Eberraute=>Arrhenatherum elatius
Wermut=>Artemisia abrotanum
Einjähriger Beifuß=>Artemisia absinthium
Österreichischer Beifuß=>Artemisia annua
Feld-Beifuß=>Artemisia austriaca
Estragon=>Artemisia campestris
Pontischer Beifuß=>Artemisia dracunculus
Besen-Beifuß=>Artemisia pontica
Echte Edelraute=>Artemisia scoparia
Kamtschatka-Beifuß=>Artemisia umbelliformis
Gewöhnlicher Beifuß=>Artemisia verlotiorum
Gefleckter Aronstab=>Artemisia vulgaris
Wald-Geißbart=>Arum maculatum
Haselwurz=>Aruncus dioicus
Syrische Seidenpflanze=>Asarum europaeum
Gemüse-Spargel=>Asclepias syriaca
Quirliger Spargel=>Asparagus officinalis
Niederliegendes Scharfkraut=>Asparagus verticillatus
Acker-Meier=>Asperugo procumbens
Hügel-Meier=>Asperula arvensis
Felsen-Meier=>Asperula cynanchica
Blauer Waldmeister=>Asperula neilreichii
Rosenwaldmeister=>Asperula orientalis
Turiner Meier=>Asperula stylosa
Färber-Meier=>Asperula taurina
Schwarzer Streifenfarn=>Asperula tinctoria
Serpentin-Streifenfarn=>Asplenium adiantum-nigrum
Braungrüner Streifenfarn=>Asplenium cuneifolium
Schriftfarn=>Asplenium adulterinum
Zerschlitzter Streifenfarn=>Asplenium ceterach
Jura-Streifenfarn=>Asplenium fissum
Mauerraute=>Asplenium fontanum
Dolomit-Streifenfarn=>Asplenium ruta-muraria
Nordischer Streifenfarn=>Asplenium seelosii
Brauner Streifenfarn=>Asplenium septentrionale
Grüner Streifenfarn=>Asplenium trichomanes
Alpen-Aster=>Asplenium viride
Kalk-Aster=>Aster alpinus
Alpen-Maßliebchen=>Aster amellus
Schleieraster=>Aster bellidiastrum
Kahle Aster=>Aster cordifolius
Lanzettblättrige Aster=>Aster laevis
Kleinblütige Aster=>Aster lanceolatus
Gold-Aster=>Aster parviflorus
Herzblättrige Aster=>Aster linosyris
Rauhblatt-Aster=>Aster macrophyllus
Glattblatt-Aster=>Aster novae-angliae
Strand-Aster=>Aster novi-belgii
Japanische Astilbe=>Aster tripolium
Alpen-Tragant=>Astilbe japonica
Sand-Tragant=>Astragalus alpinus
Südlicher Tragant=>Astragalus arenarius
Kicher-Tragant=>Astragalus australis
Dänischer Tragant=>Astragalus cicer
Gletscher-Tragant=>Astragalus danicus
Süßer Tragant=>Astragalus frigidus
Esparsetten-Tragant=>Astragalus glycyphyllos
Blasen-Tragant=>Astragalus onobrychis
Bayerische Sterndolde=>Astragalus penduliflorus
Große Sterndolde=>Astrantia bavarica
Zottige Augenwurz=>Astrantia major
Gebirgs-Frauenfarn=>Athamanta cretensis
Wald-Frauenfarn=>Athyrium distentifolium
Garten-Melde=>Athyrium filix-femina
Verschiedensamige Melde=>Atriplex hortensis
Langblättrige Melde=>Atriplex micrantha
Spreizende Melde=>Atriplex oblongifolia
Pfeilblättrige Melde=>Atriplex patula
Spieß-Melde=>Atriplex calotheca
Rosen-Melde=>Atriplex prostrata
Glanz-Melde=>Atriplex rosea
Tataren-Melde=>Atriplex sagittata
Echte Tollkirsche=>Atriplex tatarica
Blaukissen=>Atropa bella-donna
Felsen-Steinkraut=>Aubrieta deltoidea
Kurzhafer=>Aurinia saxatilis
Flug-Hafer=>Avena brevis
Fahnenhafer=>Avena fatua
Saat-Hafer=>Avena orientalis
Großer Algenfarn=>Avena sativa
Schwarznessel=>Azolla filiculoides
Mittleres Barbarakraut=>Ballota nigra
Steifes Barbarakraut=>Barbarea intermedia
Frühlings-Barbarakraut=>Barbarea stricta
Gewöhnliches Barbarakraut=>Barbarea verna
Europäischer Alpenhelm=>Barbarea vulgaris
Dornmelde=>Bartsia alpina
Sand-Radmelde=>Bassia hyssopifolia
Besen-Radmelde=>Bassia laniflora
Gewöhnliches Doppelährengras=>Bassia scoparia
Thunbergs Berberitze=>Beckmannia syzigachne
Gewöhnliche Berberitze=>Berberis thunbergii
Dickblatt-Bergenie=>Berberis vulgaris
Sand-Graukresse=>Bergenia crassifolia
Schmalblättriger Merk=>Berteroa incana
Rübe=>Berula erecta
Fuchsschwanz-Ziest=>Beta vulgaris
Monier-Ziest=>Betonica alopecuros
Heil-Ziest=>Betonica monieri
Strauch-Birke=>Betonica officinalis
Zwerg-Birke=>Betula humilis
Hänge-Birke=>Betula nana
Moor-Birke=>Betula pendula
Nickender Zweizahn=>Betula pubescens
Verwachsenblättriger Zweizahn=>Bidens cernua
Gold-Zweizahn=>Bidens connata
Schwarzfrüchtiger Zweizahn=>Bidens ferulifolia
Strahliger Zweizahn=>Bidens frondosa
Dreiteiliger Zweizahn=>Bidens radiata
Strahlen-Hohlsame=>Bidens tripartita
Brillenschötchen=>Bifora radians
Kerzenknöterich=>Biscutella laevigata
Schlangen-Knöterich=>Bistorta amplexicaulis
Knöllchen-Knöterich=>Bistorta officinalis
Gewöhnlicher Rippenfarn=>Bistorta vivipara
Zusammengedrücktes Quellried=>Blechnum spicant
Verkannte Strandsimse=>Blysmus compressus
Borretsch=>Bolboschoenus yagara
Orient-Boreave=>Borago officinalis
Blutstillendes Bartgras=>Boreava orientalis
Echte Mondraute=>Bothriochloa ischaemum
Ästige Mondraute=>Botrychium lunaria
Vielteilige Mondraute=>Botrychium matricariifolium
Virginische Mondraute=>Botrychium multifidum
Rippen-Fiederzwenke=>Botrychium virginianum
Gewöhnliche Fiederzwenke=>Brachypodium phoenicoides
Felsen-Fiederzwenke=>Brachypodium pinnatum
Wald-Fiederzwenke=>Brachypodium rupestre
Langtraubiger Kohl=>Brachypodium sylvaticum
Ruten-Kohl=>Brassica elongata
Raps=>Brassica juncea
Schwarzer Senf=>Brassica napus
Gemüse-Kohl=>Brassica nigra
Stoppelrübe=>Brassica oleracea
Großes Zittergras=>Brassica rapa
Gewöhnliches Zittergras=>Briza maxima
Kleines Zittergras=>Briza media
Fuchsschwanz-Trespe=>Briza minor
Acker-Trespe=>Bromus alopecuros
Plattährige Trespe=>Bromus arvensis
Ährengrasähnliche Trespe=>Bromus carinatus
Großährige Trespe=>Bromus catharticus
Steife Trespe=>Bromus diandrus
Aufrechte Trespe=>Bromus rigidus
Weiche Trespe=>Bromus erectus
Zierliche Trespe=>Bromus hordeaceus
Unbegrannte Trespe=>Bromus lepidus
Japanische Trespe=>Bromus inermis
Lanzettblütige Trespe=>Bromus japonicus
Mittelmeer-Trespe=>Bromus lanceolatus
Wiesen-Trespe=>Bromus madritensis
Trauben-Trespe=>Bromus commutatus
Rauhe Wald-Trespe=>Bromus racemosus
Gewöhnliche Wald-Trespe=>Bromus benekenii
Besen-Trespe=>Bromus ramosus
Dicke Trespe=>Bromus scoparius
Roggen-Trespe=>Bromus grossus
Sparrige Trespe=>Bromus secalinus
Taube Trespe=>Bromus squarrosus
Dach-Trespe=>Bromus sterilis
Kaukasusvergißmeinnicht=>Bromus tectorum
Schwarzfrüchtige Zaunrübe=>Brunnera macrophylla
Rotfrüchtige Zaunrübe=>Bryonia alba
Schmetterlingsstrauch=>Bryonia dioica
Geflügeltes Zackenschötchen=>Buddleja davidii
Orientalisches Zackenschötchen=>Bunias erucago
Gewöhnlicher Knollenkümmel=>Bunias orientalis
Weidenblättriges Ochsenauge=>Bunium bulbocastanum
Sichelblättriges Hasenohr=>Buphthalmum salicifolium
Lanzettblättriges Hasenohr=>Bupleurum falcatum
Langblättriges Hasenohr=>Bupleurum lancifolium
Hahnenfuß-Hasenohr=>Bupleurum longifolium
Rundblättriges Hasenohr=>Bupleurum ranunculoides
Schwanenblume=>Bupleurum rotundifolium
Europäischer Buchsbaum=>Butomus umbellatus
Europäischer Meersenf=>Buxus sempervirens
Wald-Reitgras=>Cakile maritima
Sumpf-Reitgras=>Calamagrostis arundinacea
Purpur-Reitgras=>Calamagrostis canescens
Land-Reitgras=>Calamagrostis phragmitoides
Ufer-Reitgras=>Calamagrostis epigejos
Moor-Reitgras=>Calamagrostis pseudophragmites
Buntes Reitgras=>Calamagrostis stricta
Wolliges Reitgras=>Calamagrostis varia
Einseles Bergminze=>Calamagrostis villosa
Wald-Bergminze=>Calamintha einseleana
Kleinblütige Bergminze=>Calamintha menthifolia
Herzlöffel=>Calamintha nepeta
Acker-Ringelblume=>Caldesia parnassifolia
Garten-Ringelblume=>Calendula arvensis
Wendich=>Calendula officinalis
Schlangenwurz=>Calepina irregularis
Sommeraster=>Calla palustris
Herbst-Wasserstern=>Callistephus chinensis
Stumpfkantiger Wasserstern=>Callitriche hermaphroditica
Haken-Wasserstern=>Callitriche cophocarpa
Nussfrüchtiger Wasserstern=>Callitriche hamulata
Sumpf-Wasserstern=>Callitriche obtusangula
Flachfrüchtiger Wasserstern=>Callitriche palustris
Teich-Wasserstern=>Callitriche platycarpa
Sumpf-Dotterblume=>Callitriche stagnalis
Schöne Zaunwinde=>Caltha palustris
Echte Zaunwinde=>Calystegia pulchra
Gezähnter Leindotter=>Calystegia sepium
Kleinfrüchtiger Leindotter=>Camelina alyssum
Saat-Leindotter=>Camelina microcarpa
Alpen-Glockenblume=>Camelina sativa
Bärtige Glockenblume=>Campanula alpina
Karpatenglockenblume=>Campanula barbata
Borstige Glockenblume=>Campanula carpatica
Zwerg-Glockenblume=>Campanula cervicaria
Neapolitanische Glockenblume=>Campanula cochleariifolia
Büschel-Glockenblume=>Campanula fragilis
Breitblättrige Glockenblume=>Campanula glomerata
Marien-Glockenblume=>Campanula latifolia
Wiesen-Glockenblume=>Campanula medium
Pfirsichblättrige Glockenblume=>Campanula patula
Polsterglockenblume=>Campanula persicifolia
Acker-Glockenblume=>Campanula poscharskyana
Rapunzel-Glockenblume=>Campanula rapunculoides
Rautenblättrige Glockenblume=>Campanula rapunculus
Edle Glockenblume=>Campanula rhomboidalis
Rundblättrige Glockenblume=>Campanula gentilis
Scheuchzers Glockenblume=>Campanula rotundifolia
Strauß-Glockenblume=>Campanula scheuchzeri
Nesselblättrige Glockenblume=>Campanula thyrsoides
Indisches Blumenrohr=>Campanula trachelium
Hanf=>Canna indica
Kapernstrauch=>Cannabis sativa
Gewöhnliches Hirtentäschel=>Capparis spinosa
Rötliches Hirtentäschel=>Capsella bursa-pastoris
Paprika=>Capsella rubella
Gewöhnlicher Erbsenstrauch=>Capsicum annuum
Alpen-Schaumkraut=>Caragana arborescens
Bitteres Schaumkraut=>Cardamine alpina
Zwiebel-Zahnwurz=>Cardamine amara
Quirlblättrige Zahnwurz=>Cardamine bulbifera
Wald-Schaumkraut=>Cardamine enneaphyllos
Behaartes Schaumkraut=>Cardamine flexuosa
Spring-Schaumkraut=>Cardamine hirsuta
Kitaibels Zahnwurz=>Cardamine impatiens
Kleinblütiges Schaumkraut=>Cardamine kitaibelii
Finger-Zahnwurz=>Cardamine parviflora
Sumpf-Schaumkraut=>Cardamine pentaphyllos
Wiesen-Schaumkraut=>Cardamine dentata
Morast-Schaumkraut=>Cardamine pratensis
Resedablättriges Schaumkraut=>Cardamine udicola
Kleeblättriges Schaumkraut=>Cardamine resedifolia
Sand-Schaumkresse=>Cardamine trifolia
Wiesen-Schaumkresse=>Cardaminopsis arenosa
Felsen-Schaumkresse=>Cardaminopsis halleri
Scharfe Pfeilkresse=>Cardaminopsis petraea
Weg-Distel=>Cardaria draba
Krause Distel=>Carduus acanthoides
Dickblättrige Distel=>Carduus crispus
Alpen-Distel=>Carduus crassifolius
Nickende Distel=>Carduus defloratus
Berg-Distel=>Carduus nutans
Schlank-Segge=>Carduus personata
Inn-Segge=>Carex acuta
Sumpf-Segge=>Carex randalpina
Weiße Segge=>Carex acutiformis
Schwarzschopf-Segge=>Carex alba
Sand-Segge=>Carex appropinquata
Trauer-Segge=>Carex arenaria
Kleinblütige Segge=>Carex atrata
Monte Baldo-Segge=>Carex parviflora
Zypergras-Segge=>Carex baldensis
Kurzährige Segge=>Carex bohemica
Zittergras-Segge=>Carex brachystachys
Banater Segge=>Carex brizoides
Buxbaums Segge=>Carex buekii
Hartmans Segge=>Carex buxbaumii
Bräunliche Segge=>Carex hartmanii
Graue Segge=>Carex brunnescens
Haarstielige Segge=>Carex canescens
Kopf-Segge=>Carex capillaris
Frühlings-Segge=>Carex capitata
Rasen-Segge=>Carex caryophyllea
Fadenwurzelige Segge=>Carex cespitosa
Krumm-Segge=>Carex chordorrhiza
Davalls Segge=>Carex curvula
Draht-Segge=>Carex davalliana
Finger-Segge=>Carex diandra
Zweihäusige Segge=>Carex digitata
Entferntährige Segge=>Carex dioica
Zweizeilige Segge=>Carex distans
Igel-Segge=>Carex disticha
Steife Segge=>Carex echinata
Walzen-Segge=>Carex elata
Heide-Segge=>Carex elongata
Rost-Segge=>Carex ericetorum
Polster-Segge=>Carex ferruginea
Blaugrüne Segge=>Carex firma
Grünliche Gelb-Segge=>Carex flacca
Gewöhnliche Gelb-Segge=>Carex demissa
Schuppenfrüchtige Gelb-Segge=>Carex flava
Späte Gelb-Segge=>Carex lepidocarpa
Kälteliebende Segge=>Carex viridula
Ruß-Segge=>Carex frigida
Morgenstern-Segge=>Carex fuliginosa
Torf-Segge=>Carex grayi
Behaarte Segge=>Carex heleonastes
Saum-Segge=>Carex hirta
Erd-Segge=>Carex hostiana
Faden-Segge=>Carex humilis
Schlamm-Segge=>Carex lasiocarpa
Michelis Segge=>Carex limosa
Kleine Grannen-Segge=>Carex michelii
Berg-Segge=>Carex microglochin
Stachelspitzige Segge=>Carex montana
Unterbrochenährige Segge=>Carex mucronata
Leers Segge=>Carex divulsa
Sparrige Segge=>Carex guestphalica
Pairas Segge=>Carex muricata
Stachel-Segge=>Carex pairae
Wiesen-Segge=>Carex spicata
Vogelfuß-Segge=>Carex nigra
Kahlfrüchtige Vogelfuß-Segge=>Carex ornithopoda
Hasenfuß-Segge=>Carex ornithopodioides
Bleiche Segge=>Carex ovalis
Hirse-Segge=>Carex pallescens
Rispen-Segge=>Carex panicea
Armblütige Segge=>Carex paniculata
Riesel-Segge=>Carex pauciflora
Hänge-Segge=>Carex paupercula
Wimper-Segge=>Carex pendula
Pillen-Segge=>Carex pilosa
Frühe Segge=>Carex pilulifera
Scheinzypergras-Segge=>Carex praecox
Floh-Segge=>Carex pseudocyperus
Winkel-Segge=>Carex pulicaris
Ufer-Segge=>Carex remota
Schnabel-Segge=>Carex riparia
Felsen-Segge=>Carex rostrata
Immergrüne Segge=>Carex rupestris
Dünnährige Segge=>Carex sempervirens
Niedrige Segge=>Carex strigosa
Wald-Segge=>Carex supina
Filz-Segge=>Carex sylvatica
Schatten-Segge=>Carex tomentosa
Blasen-Segge=>Carex umbrosa
Hain-Segge=>Carex vesicaria
Fuchs-Segge=>Carex otrubae
Fuchsseggenähnliche Segge=>Carex vulpina
Akanthusblättrige Eberwurz=>Carex vulpinoidea
Silberdistel=>Carlina acanthifolia
Steife Eberwurz=>Carlina acaulis
Golddistel=>Carlina biebersteinii
Nickende Kragenblume=>Carlina vulgaris
Hainbuche=>Carpesium cernuum
Wolliger Saflor=>Carpinus betulus
Färber-Distel=>Carthamus lanatus
Wiesen-Kümmel=>Carthamus tinctorius
Vielblütiger Kümmel=>Carum carvi
Schindelborkige Hickorie=>Carum multiflorum
Ess-Kastanie=>Carya ovata
Europäisches Quellgras=>Castanea sativa
Gewöhnlicher Trompetenbaum=>Catabrosa aquatica
Aufrechtes Steifgras=>Catalpa bignonioides
Acker-Haftdolde=>Catapodium rigidum
Rundblättriger Baumwürger=>Caucalis platycarpos
Südlicher Zürgelbaum=>Celastrus orbiculatus
Westlicher Zürgelbaum=>Celtis australis
Stern-Flockenblume=>Celtis occidentalis
Kornblume, Blaue Flockenblume=>Centaurea calcitrapa
Kaukasische Flockenblume=>Centaurea cyanus
Orient-Kornblume=>Centaurea dealbata
Sparrige Flockenblume=>Centaurea depressa
Trübe Flockenblume=>Centaurea diffusa
Wiesen-Flockenblume=>Centaurea diluta
Riesenblütige Flockenblume=>Centaurea jacea
Berg-Flockenblume=>Centaurea macrocephala
Schwarze Flockenblume=>Centaurea montana
Schwärzliche Flockenblume=>Centaurea nigra
Perücken-Flockenblume=>Centaurea nigrescens
Schmalschuppige Flockenblume=>Centaurea pseudophrygia
Skabiosen-Flockenblume=>Centaurea stenolepis
Sonnenwend-Flockenblume=>Centaurea scabiosa
Rispen-Flockenblume=>Centaurea solstitialis
Filzige Flockenblume=>Centaurea stoebe
Echtes Tausendgüldenkraut=>Centaurea triumfettii
Strand-Tausendgüldenkraut=>Centaurium erythraea
Kleines Tausendgüldenkraut=>Centaurium littorale
Rote Spornblume=>Centaurium pulchellum
Weißes Waldvögelein=>Centranthus ruber
Schwertblättriges Waldvögelein=>Cephalanthera damasonium
Rotes Waldvögelein=>Cephalanthera longifolia
Riesen-Schuppenkopf=>Cephalanthera rubra
Syrischer Schuppenkopf=>Cephalaria gigantea
Siebenbürger Schuppenkopf=>Cephalaria syriaca
Alpen-Hornkraut=>Cephalaria transsylvanica
Acker-Hornkraut=>Cerastium alpinum
Bodendecker-Hornkraut=>Cerastium arvense
Bärtiges Hornkraut=>Cerastium biebersteinii
Tenores Hornkraut=>Cerastium brachypetalum
Dreigriffeliges Hornkraut=>Cerastium tenoreanum
Zweigabeliges Hornkraut=>Cerastium cerastoides
Klebriges Hornkraut=>Cerastium dichotomum
Quellen-Hornkraut=>Cerastium dubium
Gewöhnliches Hornkraut=>Cerastium fontanum
Großfrüchtiges Hornkraut=>Cerastium holosteoides
Knäuel-Hornkraut=>Cerastium lucorum
Breitblättriges Hornkraut=>Cerastium glomeratum
Bleiches Hornkraut=>Cerastium latifolium
Dunkles Hornkraut=>Cerastium glutinosum
Sand-Hornkraut=>Cerastium pumilum
Filziges Hornkraut=>Cerastium semidecandrum
Einblütiges Hornkraut=>Cerastium tomentosum
Rankender Lerchensporn=>Cerastium uniflorum
Sichelfrüchtiges Hornköpfchen=>Ceratocapnos claviculata
Rauhes Hornblatt=>Ceratocephala falcata
Zartes Hornblatt=>Ceratophyllum demersum
Alpen-Wachsblume=>Ceratophyllum submersum
Kleine Wachsblume=>Cerinthe glabra
Japanische Scheinquitte=>Cerinthe minor
Kleines Leinkraut=>Chaenomeles japonica
Kleiner Orant=>Chaenorhinum minus
Aromatischer Kälberkropf=>Chaenorhinum origanifolium
Gold-Kälberkropf=>Chaerophyllum aromaticum
Knolliger Kälberkropf=>Chaerophyllum aureum
Rauhhaariger Kälberkropf=>Chaerophyllum bulbosum
Hecken-Kälberkropf=>Chaerophyllum hirsutum
Lawsons Scheinzypresse=>Chaerophyllum temulum
Regensburger Geißklee=>Chamaecyparis lawsoniana
Kopf-Geißklee=>Chamaecytisus ratisbonensis
Gemischte Spornkamille=>Chamaecytisus supinus
Römische Kamille=>Chamaemelum mixtum
Gewöhnlicher Flügelginster=>Chamaemelum nobile
Niederliegende Wolfsmilch=>Chamaespartium sagittale
Gefleckte Wolfsmilch=>Chamaesyce humifusa
Niederliegende Schiefblattwolfsmilch=>Chamaesyce maculata
Kriechende Zwerg-Wolfsmilch=>Chamaesyce prostrata
Alpen-Zwergorchis=>Chamaesyce serpens
Gewöhnliches Schöllkraut=>Chamorchis alpina
Weißer Gänsefuß=>Chelidonium majus
Riesen-Gänsefuß=>Chenopodium album
Schneeballblättriger Gänsefuß=>Chenopodium giganteum
Gestreifter Gänsefuß=>Chenopodium opulifolium
Schwedischer Gänsefuß=>Chenopodium strictum
Wohlriechender Gänsefuß=>Chenopodium suecicum
Klebriger Gänsefuß=>Chenopodium ambrosioides
Kopfiger Erdbeerspinat=>Chenopodium botrys
Feigenblättriger Gänsefuß=>Chenopodium capitatum
Echter Erdbeerspinat=>Chenopodium ficifolium
Graugrüner Gänsefuß=>Chenopodium foliosum
Bocks-Gänsefuß=>Chenopodium glaucum
Bastard-Gänsefuß=>Chenopodium hircinum
Mauer-Gänsefuß=>Chenopodium hybridum
Pilcomayo-Gänsefuß=>Chenopodium murale
Vielsamiger Gänsefuß=>Chenopodium pilcomayense
Schmalblättriger Gänsefuß=>Chenopodium polyspermum
Probsts Gänsefuß=>Chenopodium desiccatum
Australischer Gänsefuß=>Chenopodium probstii
Reismelde=>Chenopodium pumilio
Kreiselblättriger Gänsefuß=>Chenopodium quinoa
Roter Gänsefuß=>Chenopodium rhombifolium
Schraders Gänsefuß=>Chenopodium rubrum
Straßen-Gänsefuß=>Chenopodium schraderianum
Stinkender Gänsefuß=>Chenopodium urbicum
Dolden-Winterlieb=>Chenopodium vulvaria
Große Sternhyazinthe=>Chimaphila umbellata
Gewöhnliche Sternhyazinthe=>Chionodoxa forbesii
Dunkle Sternhyazinthe=>Chionodoxa luciliae
Grünlilie=>Chionodoxa sardensis
Alpen-Knorpellattich=>Chlorophytum comosum
Großer Knorpellattich=>Chondrilla chondrilloides
Zarte Rettichlevkoje=>Chondrilla juncea
Goldblume=>Chorispora tenella
Kronen-Wucherblume=>Chrysanthemum coreanum
Saat-Wucherblume=>Chrysanthemum coronarium
Wechselblättriges Milzkraut=>Chrysanthemum segetum
Gegenblättriges Milzkraut=>Chrysosplenium alternifolium
Europäischer Fadenenzian=>Chrysosplenium oppositifolium
Kichererbse=>Cicendia filiformis
Alpen-Milchlattich=>Cicer arietinum
Großblättriger Milchlattich=>Cicerbita alpina
Kahle Wegwarte=>Cicerbita macrophylla
Endivie=>Cichorium calvum
Giftiger Wasserschierling=>Cichorium endivia
Alpen-Hexenkraut=>Cicuta virosa
Gewöhnliches Hexenkraut=>Circaea alpina
Stängellose Kratzdistel=>Circaea lutetiana
Acker-Kratzdistel=>Cirsium acaule
Graue Kratzdistel=>Cirsium arvense
Wollköpfige Kratzdistel=>Cirsium canum
Verschiedenblättrige Kratzdistel=>Cirsium eriophorum
Kohl-Kratzdistel=>Cirsium heterophyllum
Sumpf-Kratzdistel=>Cirsium oleraceum
Bach-Kratzdistel=>Cirsium palustre
Alpen-Kratzdistel=>Cirsium rivulare
Knollige Kratzdistel=>Cirsium spinosissimum
Gewöhnliche Kratzdistel=>Cirsium tuberosum
Montpellier-Zistrose=>Cirsium vulgare
Wassermelone=>Cistus monspeliensis
Pomeranze=>Citrullus lanatus
Binsen-Schneide=>Citrus aurantium
Sommerazalee=>Cladium mariscus
Mandelröschen=>Clarkia amoena
Gewöhnliches Tellerkraut=>Clarkia unguiculata
Sibirisches Tellerkraut=>Claytonia perfoliata
Alpen-Waldrebe=>Claytonia sibirica
Ganzblättrige Waldrebe=>Clematis alpina
Aufrechte Waldrebe=>Clematis integrifolia
Mongolische Waldrebe=>Clematis recta
Gewöhnliche Waldrebe=>Clematis tangutica
Italienische Waldrebe=>Clematis vitalba
Spinnenpflanze=>Clematis viticella
Wirbeldost=>Cleome spinosa
Echtes Benediktenkraut=>Clinopodium vulgare
Sumpf-Brenndolde=>Cnicus benedictus
Silgenblättrige Brenndolde=>Cnidium dubium
Dänisches Löffelkraut=>Cnidium silaifolium
Bayerisches Löffelkraut=>Cochlearia danica
Echtes Löffelkraut=>Cochlearia bavarica
Pyrenäen-Löffelkraut=>Cochlearia officinalis
Grüne Hohlzunge=>Cochlearia pyrenaica
Schnabelsenf=>Coeloglossum viride
Herbst-Zeitlose=>Coincya monensis
Kranz-Wucherblume=>Colchicum autumnale
Zweifarbige Collinsie=>Coleostephus myconis
Großblumige Leimsaat=>Collinsia bicolor
Gewöhnlicher Blasenstrauch=>Collomia grandiflora
Gewöhnliche Commelina=>Colutea arborescens
Gefleckter Schierling=>Commelina communis
Französische Erdkastanie=>Conium maculatum
Österreichischer Ackerkohl=>Conopodium majus
Gewöhnlicher Ackerkohl=>Conringia austriaca
Garten-Rittersporn=>Conringia orientalis
Spanischer Rittersporn=>Consolida ajacis
Griechischer Rittersporn=>Consolida hispanica
Acker-Rittersporn=>Consolida phrygia
Maiglöckchen=>Consolida regalis
Acker-Winde=>Convallaria majalis
Südamerikanisches Berufkraut=>Convolvulus arvensis
Kanadisches Berufkraut=>Conyza bonariensis
Gewöhnliche Korallenwurz=>Conyza canadensis
Sterntaler=>Corallorrhiza trifida
Färber-Mädchenauge=>Coreopsis lanceolata
Nadelblättriges Mädchenauge=>Coreopsis tinctoria
Echter Koriander=>Coreopsis verticillata
Schmalflügeliger Wanzensame=>Coriandrum sativum
Weißer Hartriegel=>Corispermum leptopterum
Kornelkirsche=>Cornus alba
Blutroter Hartriegel=>Cornus mas
Weißer Hartriegel=>Cornus sanguinea
Berg-Kronwicke=>Cornus sericea
Scheiden-Kronwicke=>Coronilla coronata
Zweiknotiger Krähenfuß=>Coronilla vaginalis
Niederliegender Krähenfuß=>Coronopus didymus
Gewöhnlicher Hirschsprung=>Coronopus squamatus
Alpen-Heilglöckchen=>Corrigiola litoralis
Hohler Lerchensporn=>Cortusa matthioli
Mittlerer Lerchensporn=>Corydalis cava
Gefingerter Lerchensporn=>Corydalis intermedia
Europäische Hasel=>Corydalis solida
Baum-Hasel=>Corylus avellana
Lamberts Hasel=>Corylus colurna
Gewöhnliches Silbergras=>Corylus maxima
Schmuckkörbchen=>Corynephorus canescens
Europäischer Perückenstrauch=>Cosmos bipinnatus
Spitzblättrige Zwergmispel=>Cotinus coggygria
Runzel-Zwergmispel=>Cotoneaster acutifolius
Teppich-Zwergmispel=>Cotoneaster bullatus
Diels Zwergmispel=>Cotoneaster dammeri
Sparrige Zwergmispel=>Cotoneaster dielsianus
Fächer-Zwergmispel=>Cotoneaster divaricatus
Felsen-Zwergmispel=>Cotoneaster horizontalis
Spitzblättrige Strauchmispel=>Cotoneaster integerrimus
Zwergmispel=>Cotoneaster lucidus
Filzige Zwergmispel=>Cotoneaster praecox
Nadelkraut-Dickblatt=>Cotoneaster tomentosus
Moos-Dickblatt=>Crassula helmsii
Scharlachdorn=>Crassula tillaea
Hahnenkamm-Weißdorn=>Crataegus coccinea
Zweigriffliger Weißdorn=>Crataegus crus-galli
Eingriffliger Weißdorn=>Crataegus laevigata
Großkelchiger Weißdorn=>Crataegus monogyna
Alpen-Pippau=>Crataegus rhipidophylla
Gold-Pippau=>Crepis alpestris
Wiesen-Pippau=>Crepis aurea
Berg-Pippau=>Crepis biennis
Kleinköpfiger Pippau=>Crepis bocconi
Großköpfiger Pippau=>Crepis capillaris
Stinkender Pippau=>Crepis conyzifolia
Felsen-Pippau=>Crepis foetida
Weichhaariger Pippau=>Crepis jacquinii
Franzosen-Pippau=>Crepis mollis
Sumpf-Pippau=>Crepis nicaeensis
Abgebissener Pippau=>Crepis paludosa
Schöner Pippau=>Crepis praemorsa
Schabenkraut-Pippau=>Crepis pulchra
Borsten-Pippau=>Crepis pyrenaica
Dach-Pippau=>Crepis setosa
Triglav-Pippau=>Crepis tectorum
Löwenzahnblättriger Pippau=>Crepis terglouensis
Gelber Krokus=>Crepis vesicaria
Gold-Krokus=>Crocus chrysanthus
Tommasini-Krokus=>Crocus flavus
Frühlings-Safran=>Crocus tommasinianus
Kahles Kreuzlabkraut=>Crocus vernus
Gewöhnliches Kreuzlabkraut=>Cruciata glabra
Piemont-Kreuzlabkraut=>Cruciata laevipes
Dorngras=>Cruciata pedemontana
Krauser Rollfarn=>Crypsis alopecuroides
Beeren-Taubenkropf=>Cryptogramma crispa
Zucker-Melone=>Cucubalus baccifer
Gurke=>Cucumis melo
Riesenkürbis=>Cucumis sativus
Gewöhnlicher Kürbis=>Cucurbita maxima
Nordamerikanische Seide=>Cucurbita pepo
Flachs-Seide=>Cuscuta campestris
Quendel-Seide=>Cuscuta epilinum
Nessel-Seide=>Cuscuta epithymum
Gronovius Seide=>Cuscuta europaea
Pappel-Seide=>Cuscuta gronovii
Südliche Seide=>Cuscuta lupuliformis
Chilenische Seide=>Cuscuta scandens
Wildes Alpenveilchen=>Cuscuta suaveolens
Echte Quitte=>Cyclamen purpurascens
Bleiches Zimbelkraut=>Cydonia oblonga
Bewimpertes Zymbelkraut=>Cymbalaria pallida
Gewöhnliches Hundszahngras=>Cymbalaria pilosa
Kretische Hundszunge=>Cynodon dactylon
Deutsche Hundszunge=>Cynoglossum creticum
Gewöhnliche Hundszunge=>Cynoglossum germanicum
Wiesen-Kammgras=>Cynoglossum officinale
Stachel-Kammgras=>Cynosurus cristatus
Frischgrünes Zypergras=>Cynosurus echinatus
Gelbliches Zypergras=>Cyperus eragrostis
Braunes Zypergras=>Cyperus flavescens
Schirm-Zypergras=>Cyperus fuscus
Hohes Zypergras=>Cyperus involucratus
Europäischer Frauenschuh=>Cyperus longus
Alpen-Blasenfarn=>Cypripedium calceolus
Runzelsporiger Blasenfarn=>Cystopteris alpina
Zerbrechlicher Blasenfarn=>Cystopteris dickieana
Berg-Blasenfarn=>Cystopteris fragilis
Sudeten-Blasenfarn=>Cystopteris montana
Vielblütiger Geißklee=>Cystopteris sudetica
Schwarzwerdender Geißklee=>Cytisus multiflorus
Besen-Ginster=>Cytisus nigricans
Gestreifter Ginster=>Cytisus scoparius
Wiesen-Knäuelgras=>Cytisus striatus
Wald-Knäuelgras=>Dactylis glomerata
Fleischfarbenes Knabenkraut=>Dactylis polygama
Bleichgelbes Knabenkraut=>Dactylorhiza incarnata
Fuchs' Knabenkraut=>Dactylorhiza ochroleuca
Geflecktes Knabenkraut=>Dactylorhiza fuchsii
Lappländisches Knabenkraut=>Dactylorhiza maculata
Breitblättriges Knabenkraut=>Dactylorhiza lapponica
Übersehenes Knabenkraut=>Dactylorhiza majalis
Traunsteiners Knabenkraut=>Dactylorhiza praetermissa
Holunder-Knabenkraut=>Dactylorhiza traunsteineri
Kelch-Traubenhafer=>Dactylorhiza sambucina
Dreizahn=>Danthonia alpina
Blagays Seidelbast=>Danthonia decumbens
Rosmarin-Seidelbast=>Daphne blagayana
Gewöhnlicher Seidelbast=>Daphne cneorum
Gestreifter Seidelbast=>Daphne mezereum
Zottiger Haarweizen=>Daphne striata
Großblütiger Stechapfel=>Dasypyrum villosum
Weißer Stechapfel=>Datura innoxia
Wilde Möhre=>Datura stramonium
Rasen-Schmiele=>Daucus carota
Bodensee-Schmiele=>Deschampsia cespitosa
Draht-Schmiele=>Deschampsia littoralis
Moor-Schmiele=>Avenella flexuosa
Gewöhnliche Besenrauke=>Deschampsia setacea
Raublättrige Deutzie=>Descurainia sophia
Büschel-Nelke=>Deutzia scabra
Bart-Nelke=>Dianthus armeria
Karthäuser-Nelke=>Dianthus barbatus
Heide-Nelke=>Dianthus carthusianorum
Riesen-Nelke=>Dianthus deltoides
Pfingst-Nelke=>Dianthus giganteus
Feder-Nelke=>Dianthus gratianopolitanus
Busch-Nelke=>Dianthus plumarius
Pracht-Nelke=>Dianthus seguieri
Stein-Nelke=>Dianthus superbus
Zwergherzblume=>Dianthus sylvestris
Tränendes Herz=>Dicentra formosa
Gewöhnlicher Diptam=>Dicentra spectabilis
Kapselgeißblatt=>Dictamnus albus
Großblütiger Fingerhut=>Diervilla lonicera
Wolliger Fingerhut=>Digitalis grandiflora
Gelber Fingerhut=>Digitalis lanata
Faden-Fingerhirse=>Digitalis lutea
Blutrote Fingerhirse=>Digitaria ischaemum
Alpen-Flachbärlapp=>Digitaria sanguinalis
Gewöhnlicher Flachbärlapp=>Diphasiastrum alpinum
Isslers Flachbärlapp=>Diphasiastrum complanatum
Oellgaards Flachbärlapp=>Diphasiastrum issleri
Zypressen-Flachbärlapp=>Diphasiastrum oellgaardii
Zeillers Flachbärlapp=>Diphasiastrum tristachyum
Raukenähnlicher Doppelsame=>Diphasiastrum zeilleri
Mauer-Doppelsame=>Diplotaxis erucoides
Schmalblättriger Doppelsame=>Diplotaxis muralis
Ruten-Doppelsame=>Diplotaxis tenuifolia
Wilde Karde=>Diplotaxis viminea
Schlitzblättrige Karde=>Dipsacus fullonum
Behaarte Karde=>Dipsacus laciniatus
Weber-Karde=>Dipsacus pilosus
Schlanke Karde=>Dipsacus sativus
Klebriger Alant=>Dipsacus strigosus
Österreichische Gemswurz=>Dittrichia graveolens
Gletscher-Gemswurz=>Doronicum austriacum
Herzblättrige Gemswurz=>Doronicum glaciale
Großblütige Gemswurz=>Doronicum columnae
Orient-Gemswurz=>Doronicum grandiflorum
Kriechende Gemswurz=>Doronicum orientale
Deutscher Backenklee=>Doronicum pardalianches
Krautiger Backenklee=>Dorycnium germanicum
Blaue Kattunblume=>Dorycnium herbaceum
Immergrünes Felsenblümchen=>Downingia elegans
Eis-Felsenblümchen=>Draba aizoides
Fladnitzer Felsenblümchen=>Draba dubia
Langgriffeliges Felsenblümchen=>Draba fladnizensis
Mauer-Felsenblümchen=>Draba incana
Hain-Felsenblümchen=>Draba muralis
Sauters Felsenblümchen=>Draba nemorosa
Kärntner Felsenblümchen=>Draba sauteri
Filziges Felsenblümchen=>Draba siliquosa
Nordischer Drachenkopf=>Draba tomentosa
Dreiblütiger Drachenkopf=>Dracocephalum ruyschiana
Mittlerer Sonnentau=>Dracocephalum triflorum
Langblättriger Sonnentau=>Drosera intermedia
Rundblättriger Sonnentau=>Drosera longifolia
Weiße Silberwurz=>Drosera rotundifolia
Gewöhnlicher Dornfarn=>Dryas octopetala
Breitblättriger Dornfarn=>Dryopteris carthusiana
Feingliedriger Dornfarn=>Dryopteris dilatata
Kamm-Wurmfarn=>Dryopteris expansa
Spreuschuppiger Wurmfarn=>Dryopteris cristata
Gewöhnlicher Wurmfarn=>Dryopteris affinis
Entferntfiedriger Dornfarn=>Dryopteris filix-mas
Starrer Wurmfarn=>Dryopteris remota
Indische Scheinerdbeere=>Dryopteris villarii
Spritzgurke=>Duchesnea indica
Schamahirse=>Ecballium elaterium
Gewöhnliche Hühnerhirse=>Echinochloa colonum
Japanische Hühnerhirse=>Echinochloa crus-galli
Getreide-Hühnerhirse=>Echinochloa esculenta
Stachelgurke=>Echinochloa frumentacea
Banater Kugeldistel=>Echinocystis lobata
Drüsenlose Kugeldistel=>Echinops bannaticus
Glattblättrige Kugeldistel=>Echinops exaltatus
Hoher Natternkopf=>Echinops ritro
Wegerich-Natternkopf=>Echium italicum
Gewöhnlicher Natternkopf=>Echium plantagineum
Großblüten-Wasserpest=>Echium vulgare
Schmalblättrige Ölweide=>Egeria densa
Quirl-Tännel=>Elaeagnus angustifolia
Sechsmänniger Tännel=>Elatine alsinastrum
Wasserpfeffer-Tännel=>Elatine hexandra
Dreimänniger Tännel=>Elatine hydropiper
Nadel-Sumpfbinse=>Elatine triandra
Eiförmige Sumpfbinse=>Eleocharis acicularis
Österreichische Sumpfbinse=>Eleocharis ovata
Zitzen-Sumpfbinse=>Eleocharis austriaca
Gewöhnliche Sumpfbinse=>Eleocharis mamillata
Einspelzige Sumpfbinse=>Eleocharis palustris
Armblütige Sumpfbinse=>Eleocharis uniglumis
Dünne Sumpfbinse=>Eleocharis quinqueflora
Wilder Korakan=>Eleocharis tenuis
Kanadische Wasserpest=>Eleusine indica
Schmalblättrige Wasserpest=>Elodea canadensis
Echte Kammminze=>Elodea nuttallii
Sand-Quecke=>Elsholtzia ciliata
Dünen-Quecke=>Elymus arenosus
Hunds-Quecke=>Elymus athericus
Graugrüne Quecke=>Elymus caninus
Stumpfblütige Quecke=>Elymus hispidus
Kriech-Quecke=>Elymus obtusiflorus
Zwittrige Krähenbeere=>Elymus repens
Schwarze Krähenbeere=>Empetrum hermaphroditum
Quirlblättriges Weidenröschen=>Empetrum nigrum
Mierenblättriges Weidenröschen=>Epilobium alpestre
Gauchheilblättriges Weidenröschen=>Epilobium alsinifolium
Schmalblättriges Weidenröschen=>Epilobium anagallidifolium
Kurzfrüchtiges Weidenröschen=>Epilobium angustifolium
Drüsiges Weidenröschen=>Epilobium brachycarpum
Hügel-Weidenröschen=>Epilobium ciliatum
Rosmarin-Weidenröschen=>Epilobium collinum
Kies-Weidenröschen=>Epilobium dodonaei
Zottiges Weidenröschen=>Epilobium fleischeri
Lanzettblättriges Weidenröschen=>Epilobium hirsutum
Berg-Weidenröschen=>Epilobium lanceolatum
Nickendes Weidenröschen=>Epilobium montanum
Dunkelgrünes Weidenröschen=>Epilobium nutans
Sumpf-Weidenröschen=>Epilobium obscurum
Kleinblütiges Weidenröschen=>Epilobium palustre
Rosenrotes Weidenröschen=>Epilobium parviflorum
Vierkantiges Weidenröschen=>Epilobium roseum
Alpen-Sockenblume=>Epilobium tetragonum
Gefiederte Sockenblume=>Epimedium alpinum
Braunrote Stendelwurz=>Epimedium pinnatum
Entferntblütige Stendelwurz=>Epipactis atrorubens
Breitblättrige Stendelwurz=>Epipactis distans
Schmallippige Stendelwurz=>Epipactis helleborine
Müllers Stendelwurz=>Epipactis leptochila
Rhone-Stendelwurz=>Epipactis muelleri
Kleinblättrige Stendelwurz=>Epipactis rhodanensis
Sumpf-Stendelwurz=>Epipactis microphylla
Violette Stendelwurz=>Epipactis palustris
Blattloser Widerbart=>Epipactis purpurata
Acker-Schachtelhalm=>Epipogium aphyllum
Teich-Schachtelhalm=>Equisetum arvense
Winter-Schachtelhalm=>Equisetum fluviatile
Sumpf-Schachtelhalm=>Equisetum hyemale
Wiesen-Schachtelhalm=>Equisetum palustre
Ästiger Schachtelhalm=>Equisetum pratense
Wald-Schachtelhalm=>Equisetum ramosissimum
Riesen-Schachtelhalm=>Equisetum sylvaticum
Bunter Schachtelhalm=>Equisetum telmateia
Großähriges Liebesgras=>Equisetum variegatum
Kleines Liebesgras=>Eragrostis cilianensis
Japanisches Liebesgras=>Eragrostis minor
Behaartes Liebesgras=>Eragrostis multicaulis
Tef=>Eragrostis pilosa
Winterling=>Eragrostis tef
Scheinkreuzkraut=>Eranthis hyemalis
Schnee-Heide=>Erechtites hieraciifolia
Topfheidekraut=>Erica carnea
Glocken-Heide=>Erica gracilis
Scharfes Berufkraut=>Erica tetralix
Alpen-Berufkraut=>Erigeron acris
Verkanntes Berufkraut=>Erigeron alpinus
Drüsiges Berufkraut=>Erigeron neglectus
Kahles Berufkraut=>Erigeron atticus
Mexikanisches Berufkraut=>Erigeron glabratus
Einköpfiges Berufkraut=>Erigeron karvinskianus
Alpen-Leberbalsam=>Erigeron uniflorus
Schmalblättriges Wollgras=>Erinus alpinus
Schlankes Wollgras=>Eriophorum angustifolium
Breitblättriges Wollgras=>Eriophorum gracile
Scheuchzers Wollgras=>Eriophorum latifolium
Scheidiges Wollgras=>Eriophorum scheuchzeri
Großer Reiherschnabel=>Eriophorum vaginatum
Gewöhnlicher Reiherschnabel=>Erodium ciconium
Moschus-Reiherschnabel=>Erodium cicutarium
Frühlings-Hungerblümchen=>Erodium moschatum
Rucola=>Erophila verna
Französische Hundsrauke=>Eruca sativa
Stumpfkantige Hundsrauke=>Erucastrum gallicum
Amethyst-Mannstreu=>Erucastrum nasturtiifolium
Feld-Mannstreu=>Eryngium amethystinum
Elfenbeindistel=>Eryngium campestre
Flachblättriger Mannstreu=>Eryngium giganteum
Schotendotter=>Eryngium planum
Acker-Schöterich=>Erysimum capitatum
Goldlack-Schöterich=>Erysimum cheiranthoides
Bleicher Schöterich=>Erysimum cheiri
Grauer Schöterich=>Erysimum crepidifolium
Ruten-Schöterich=>Erysimum diffusum
Harter Schöterich=>Erysimum hieraciifolium
Gewöhnlicher Schöterich=>Erysimum marschallianum
Blassgelber Schöterich=>Erysimum humile
Wohlriechender Schöterich=>Erysimum ochroleucum
Lack-Schöterich=>Erysimum odoratum
Sparriger Schöterich=>Erysimum perofskianum
Felsen-Goldlack=>Erysimum repandum
Kalifornischer Mohn=>Erysimum sylvestre
Syrisches Schnabelschötchen=>Eschscholzia californica
Gewöhnliches Pfaffenhütchen=>Euclidium syriacum
Kletter-Spindelstrauch=>Euonymus europaea
Breitblättriges Pfaffenhütchen=>Euonymus fortunei
Hanf-Wasserdost=>Euonymus latifolia
Kanten-Wolfsmilch=>Eupatorium cannabinum
Zypressen-Wolfsmilch=>Euphorbia angulata
Süße Wolfsmilch=>Euphorbia cyparissias
Vielfarbige Wolfsmilch=>Euphorbia dulcis
Esels-Wolfsmilch=>Euphorbia epithymoides
Ruten-Wolfsmilch=>Euphorbia esula
Kleine Wolfsmilch=>Euphorbia waldsteinii
Sichel-Wolfsmilch=>Euphorbia exigua
Sonnenwend-Wolfsmilch=>Euphorbia falcata
Kreuzbblättrige Wolfsmilch=>Euphorbia helioscopia
Glänzende Wolfsmilch=>Euphorbia lathyris
Schneeaufdemberge=>Euphorbia lucida
Walzen-Wolfsmilch=>Euphorbia marginata
Sumpf-Wolfsmilch=>Euphorbia myrsinites
Garten-Wolfsmilch=>Euphorbia palustris
Breitblättrige Wolfsmilch=>Euphorbia peplus
Weidenblättrige Wolfsmilch=>Euphorbia platyphyllos
Steppen-Wolfsmilch=>Euphorbia salicifolia
Steife Wolfsmilch=>Euphorbia seguieriana
Warzen-Wolfsmilch=>Euphorbia stricta
Zottige Wolfsmilch=>Euphorbia verrucosa
Bayerischer Augentrost=>Euphorbia villosa
Zottiger Augentrost=>Euphrasia bavarica
Nordischer Augentrost=>Euphrasia hirtella
Zwerg-Augentrost=>Euphrasia frigida
Schlanker Augentrost=>Euphrasia minima
Hain-Augentrost=>Euphrasia micrantha
Wiesen-Augentrost=>Euphrasia nemorosa
Salzburger Augentrost=>Euphrasia officinalis
Steifer Augentrost=>Euphrasia salisburgensis
Krainer Augentrost=>Euphrasia stricta
Echter Buchweizen=>Euphrasia tricuspidata
Tatarischer Buchweizen=>Fagopyrum esculentum
Rotbuche=>Fagopyrum tataricum
Gewöhnliche Sichelmöhre=>Fagus sylvatica
Schling-Knöterich=>Falcaria vulgaris
Winden-Knöterich=>Fallopia baldschuanica
Hecken-Knöterich=>Fallopia convolvulus
Japan-Knöterich=>Fallopia dumetorum
Sachalin-Knöterich=>Fallopia japonica
Wald-Schwingel=>Fallopia sachalinensis
Amethyst-Schwingel=>Festuca altissima
Rohr-Schwingel=>Festuca amethystina
Riesen-Schwingel=>Festuca arundinacea
Alpen-Schwingel=>Festuca gigantea
Gemsen-Schwingel=>Festuca alpina
Verschiedenblättriger Schwingel=>Festuca rupicaprina
Kleiner Schaf-Schwingel=>Festuca heterophylla
Rauhblättriger Schaf-Schwingel=>Festuca airoides
Duvals Schaf-Schwingel=>Festuca brevipila
Haar-Schaf-Schwingel=>Festuca duvalii
Blaugrüner Schaf-Schwingel=>Festuca filiformis
Harter Schaf-Schwingel=>Festuca glaucina
Derber Schaf-Schwingel=>Festuca guestfalica
Krummer Schaf-Schwingel=>Festuca heteropachys
Echter Schaf-Schwingel=>Festuca laevigata
Blasser Schaf-Schwingel=>Festuca ovina
Ungarischer Schaf-Schwingel=>Festuca pallens
Furchen-Schaf-Schwingel=>Festuca pannonica
Walliser Schaf-Schwingel=>Festuca rupicola
Wiesen-Schwingel=>Festuca valesiaca
Schöner Schwingel=>Festuca pratensis
Niedriger Schwingel=>Festuca pulchella
Ausgebreiteter Rot-Schwingel=>Festuca quadriflora
Schwärzlicher Rot-Schwingel=>Festuca heteromalla
Gewöhnlicher Rot-Schwingel=>Festuca nigrescens
Haarblättriger Rot-Schwingel=>Festuca rubra
Norischer Violett-Schwingel=>Festuca trichophylla
Dunkelvioletter Schwingel=>Festuca norica
Feige=>Festuca puccinellii
Acker-Filzkraut=>Ficus carica
Kleines Filzkraut=>Filago arvensis
Gelbliches Filzkraut=>Filago minima
Spatelblättriges Filzkraut=>Filago lutescens
Deutsches Filzkraut=>Filago pyramidata
Echtes Mädesüß=>Filago vulgaris
Kleines Mädesüß=>Filipendula ulmaria
Echter Fenchel=>Filipendula vulgaris
Zimt-Erdbeere=>Foeniculum vulgare
Wald-Erdbeere=>Fragaria moschata
Hügel-Erbeere=>Fragaria vesca
Faulbaum=>Fragaria viridis
Schmalblättrige Esche=>Frangula alnus
Oregon-Esche=>Fraxinus angustifolia
Blumen-Esche=>Fraxinus latifolia
Pennsylvanische Esche=>Fraxinus ornus
Gewöhnliche Schachblume=>Fraxinus pennsylvanica
Zwerg-Sonnenröschen=>Fritillaria meleagris
Rankender Erdrauch=>Fumana procumbens
Mauer-Erdrauch=>Fumaria capreolata
Gewöhnlicher Erdrauch=>Fumaria muralis
Kleinblütiger Erdrauch=>Fumaria officinalis
Blasser Erdrauch=>Fumaria parviflora
Geschnäbelter Erdrauch=>Fumaria vaillantii
Dunkler Erdrauch=>Fumaria rostellata
Felsen-Gelbstern=>Fumaria schleicheri
Röhriger Gelbstern=>Gagea bohemica
Wald-Gelbstern=>Gagea fragifera
Kleiner Gelbstern=>Gagea lutea
Pommerscher Gelbstern=>Gagea minima
Wiesen-Gelbstern=>Gagea pomeranica
Scheiden-Gelbstern=>Gagea pratensis
Acker-Gelbstern=>Gagea spathacea
Kokardenblume=>Gagea villosa
Elwes' Schneeglöckchen=>Gaillardia pulchella
Kleines Schneeglöckchen=>Galanthus elwesii
Arznei-Geißraute=>Galanthus nivalis
Schmalblättriger Hohlzahn=>Galega officinalis
Breitblättriger Hohlzahn=>Galeopsis angustifolia
Weichhaariger Hohlzahn=>Galeopsis ladanum
Gelber Hohlzahn=>Galeopsis pubescens
Bunter Hohlzahn=>Galeopsis segetum
Zweispaltiger Hohlzahn=>Galeopsis speciosa
Gewöhnlicher Hohlzahn=>Galeopsis bifida
Behaartes Franzosenkraut=>Galeopsis tetrahit
Kleinblütiges Franzosenkraut=>Galinsoga ciliata
Behaartes Franzosenkraut=>Galinsoga parviflora
Gewöhnliches Kletten-Labkraut=>Galinsoga quadriradiata
Grünblütiges Labkraut=>Galium aparine
Nordisches Labkraut=>Galium spurium
Krappartiges Labkraut=>Galium boreale
Blaugrünes Labkraut=>Galium rubioides
Schweizer Labkraut=>Galium glaucum
Großblütiges Wiesen-Labkraut=>Galium megalospermum
Kleinblütiges Wiesen-Labkraut=>Galium album
Traunsee-Labkraut=>Galium mollugo
Norisches Labkraut=>Galium truniacum
Waldmeister, Wohlriechendes Labkraut=>Galium noricum
Sumpf-Labkraut=>Galium odoratum
Pariser Labkraut=>Galium palustre
Ungleichblättriges Labkraut=>Galium parisiense
Zierliches Labkraut=>Galium anisophyllon
Sudeten-Labkraut=>Galium pumilum
Mährisches Labkraut=>Galium sudeticum
Rundblättriges Labkraut=>Galium valdepilosum
Felsen-Labkraut=>Galium rotundifolium
Grannen-Wald-Labkraut=>Galium saxatile
Glattes Wald-Labkraut=>Galium aristatum
Gewöhnliches Wald-Labkraut=>Galium schultesii
Dreihörniges Labkraut=>Galium sylvaticum
Moor-Labkraut=>Galium tricornutum
Echtes Labkraut=>Galium uliginosum
Wirtgens Labkraut=>Galium verum
Rauhes Nissengras=>Galium wirtgenii
Südliches Nissengras=>Gastridium scabrum
Deutscher Ginster=>Gastridium ventricosum
Behaarter Ginster=>Genista germanica
Färber-Ginster=>Genista pilosa
Kochs Enzian=>Genista tinctoria
Schwalbenwurz-Enzian=>Gentiana acaulis
Bayerischer Enzian=>Gentiana asclepiadea
Stängelloser Kalk-Enzian=>Gentiana bavarica
Kreuz-Enzian=>Gentiana clusii
Gelber Enzian=>Gentiana cruciata
Schnee-Enzian=>Gentiana lutea
Rundblättriger Enzian=>Gentiana nivalis
Ungarischer Enzian=>Gentiana orbicularis
Lungen-Enzian=>Gentiana pannonica
Tüpfel-Enzian=>Gentiana pneumonanthe
Purpur-Enzian=>Gentiana punctata
Schlauch-Enzian=>Gentiana purpurea
Frühlings-Enzian=>Gentiana utriculosa
Feld-Fransenenzian=>Gentiana verna
Gewöhnlicher Fransenenzian=>Gentianella campestris
Rauher Fransenenzian=>Gentianella ciliata
Böhmischer Fransenenzian=>Gentianella aspera
Deutscher Fransenenzian=>Gentianella bohemica
Zarter Fransenenzian=>Gentianella germanica
Stein-Storchschnabel=>Gentianella tenella
Schlitzblättriger Storchschnabel=>Geranium columbinum
Spreizender Storchschnabel=>Geranium dissectum
Basken-Storchschnabel=>Geranium divaricatum
Glänzender Storchschnabel=>Geranium endressii
Felsen-Storchschnabel=>Geranium lucidum
Weicher Storchschnabel=>Geranium macrorrhizum
Knotiger Storchschnabel=>Geranium molle
Sumpf-Storchschnabel=>Geranium nodosum
Fremder Storchschnabel=>Geranium palustre
Brauner Storchschnabel=>Geranium peregrinum
Wiesen-Storchschnabel=>Geranium phaeum
Kleiner Storchschnabel=>Geranium pratense
Pyrenäen-Storchschnabel=>Geranium pusillum
Zurückgebogener Storchschnabel=>Geranium pyrenaicum
Purpur-Storchschnabel=>Geranium reflexum
Stinkender Storchschnabel=>Geranium purpureum
Rundblättriger Storchschnabel=>Geranium robertianum
Blutroter Storchschnabel=>Geranium rotundifolium
Sibirischer Storchschnabel=>Geranium sanguineum
Berg-Nelkenwurz=>Geranium sibiricum
Kriechende Nelkenwurz=>Geum montanum
Bach-Nelkenwurz=>Geum reptans
Gewöhnliche Nelkenwurz=>Geum rivale
Schafgarbenblättriges Vogeläuglein=>Geum urbanum
Vogeläuglein=>Gilia achilleifolia
Ginkgo=>Gilia tricolor
Sumpf-Siegwurz=>Ginkgo biloba
Gewöhnliche Siegwurz=>Gladiolus palustris
Roter Hornmohn=>Gladiolus communis
Gelber Hornmohn=>Glaucium corniculatum
Strand-Milchkraut=>Glaucium flavum
Haariger Gundermann=>Glaux maritima
Amerikanische Gleditschie=>Glechoma hirsuta
Herzblättrige Kugelblume=>Gleditsia triacanthos
Nacktstenglige Kugelblume=>Globularia cordifolia
Gewöhnliche Kugelblume=>Globularia nudicaulis
Blaugrüner Schwaden=>Globularia punctata
Flutender Schwaden=>Glyceria declinata
Gefalteter Schwaden=>Glyceria fluitans
Großer Schwaden=>Glyceria notata
Gestreifter Schwaden=>Glyceria maxima
Sojabohne=>Glyceria striata
Hoppes Ruhrkraut=>Glycine max
Norwegisches Ruhrkraut=>Gnaphalium hoppeanum
Zwerg-Ruhrkraut=>Gnaphalium norvegicum
Wald-Ruhrkraut=>Gnaphalium supinum
Sumpf-Ruhrkraut=>Gnaphalium sylvaticum
Kriechendes Netzblatt=>Gnaphalium uliginosum
Gottes-Gnadenkraut=>Goodyera repens
Nordamerikanisches Grindeliakraut=>Gratiola officinalis
Dichtes Laichkraut=>Grindelia squarrosa
Ramtillkraut=>Groenlandia densa
Raues Ramtillkraut=>Guizotia abyssinica
Mücken-Händelwurz=>Guizotia scabra
Wohlriechende Händelwurz=>Gymnadenia conopsea
Eichenfarn=>Gymnadenia odoratissima
Ruprechtsfarn=>Gymnocarpium dryopteris
Geweihbaum=>Gymnocarpium robertianum
Schleierkraut=>Gymnocladus dioicus
Mauer-Gipskraut=>Gypsophila elegans
Rispiges Gipskraut=>Gypsophila muralis
Behaartes Gipskraut=>Gypsophila paniculata
Kriechendes Gipskraut=>Gypsophila pilosa
Schaftdolde=>Gypsophila repens
Sumpf-Weichwurz=>Hacquetia epipactis
Gewöhnlicher Efeu=>Hammarbya paludosa
Alpen-Süßklee=>Hedera helix
Alpen-Sonnenröschen=>Hedysarum hedysaroides
Apenninen-Sonnenröschen=>Helianthemum alpestre
Graues Sonnenröschen=>Helianthemum apenninum
Gewöhnliches Sonnenröschen=>Helianthemum canum
Gewöhnliche Sonnenblume=>Helianthemum nummularium
Monarch' Staudensonnenblume=>Helianthus annuus
Capenoch Star' - Stauden-Sonnenblume=>Helianthus atrorubens
Steife Sonnenblume=>Helianthus decapetalus
Topinambur=>Helianthus rigidus
Sand-Strohblume=>Helianthus tuberosus
Parlatores Wiesenhafer=>Helichrysum arenarium
Echter Wiesenhafer=>Helictotrichon parlatorei
Flaumiger Wiesenhafer=>Helictotrichon pratense
Bunter Wiesenhafer=>Helictotrichon pubescens
Sonnenauge=>Helictotrichon versicolor
Europäische Sonnenwende=>Heliopsis helianthoides
Stinkende Nieswurz=>Heliotropium europaeum
Schwarze Nieswurz=>Helleborus foetidus
Orient-Nieswurz=>Helleborus niger
Purpur- Nieswurz=>Helleborus orientalis
Grüne Nieswurz=>Helleborus purpurascens
Gelbrote Taglilie=>Helleborus viridis
Gelbe Taglilie=>Hemerocallis fulva
Leberblümchen=>Hemerocallis lilioasphodelus
Österreichischer Bärenklau=>Hepatica nobilis
Riesen-Bärenklau=>Heracleum austriacum
Wiesen-Bärenklau=>Heracleum mantegazzianum
Kleine Einknolle=>Heracleum sphondylium
Kahles Bruchkraut=>Herminium monorchis
Behaartes Bruchkraut=>Herniaria glabra
Graues Bruchkraut=>Herniaria hirsuta
Gewöhnliche Nachtviole=>Herniaria incana
Stundenblume=>Hesperis matronalis
Alpen-Habichtskraut=>Hibiscus trionum
Stängelumfassendes Habichtskraut=>Hieracium alpinum
Schaft-Habichtskraut=>Hieracium amplexicaule
Arlberg-Habichtskraut=>Hieracium aphyllum
Schwarzes Habichtskraut=>Hieracium arolae
Benz' Habichtskraut=>Hieracium atratum
Gabeliges Habichtskraut=>Hieracium benzianum
Boccones Habichtskraut=>Hieracium bifidum
Hasenohr-Habichtskraut=>Hieracium bocconei
Blaugraues Habichtskraut=>Hieracium bupleuroides
Grünliches Habichtskraut=>Hieracium caesium
Knorpellattich-Habichtskraut=>Hieracium chlorifolium
Löffelkraut-Habichtskraut=>Hieracium chondrillifolium
Cottets Habichtskraut=>Hieracium cochlearioides
Quittenblättriges Habichtskraut=>Hieracium cottetii
Rauhzottiges Habichtskraut=>Hieracium cydoniifolium
Gezähntes Habichtskraut=>Hieracium dasytrichum
Durchscheinendes Habichtskraut=>Hieracium dentatum
Dolliners Habichtskraut=>Hieracium diaphanoides
Peitschensprossiges Habichtskraut=>Hieracium dollineri
Fränkisches Habichtskraut=>Hieracium flagelliferum
Verkahltes Habichtskraut=>Hieracium franconicum
Frühblühendes Habichtskraut=>Hieracium glabratum
Blaugrünes Habichtskraut=>Hieracium glaucinum
Rotstängeliges Habichtskraut=>Hieracium glaucum
Harzsches Habichtskraut=>Hieracium haematopodum
Behaartes Habichtskraut=>Hieracium harzianum
Niedriges Habichtskraut=>Hieracium hirsutum
Endivien-Habichtskraut=>Hieracium humile
Schein-Jura-Habichtskraut=>Hieracium intybaceum
Jurassisches Habichtskraut=>Hieracium juraniforme
Kerners Habichtskraut=>Hieracium jurassicum
Kükenthal-Habichtskraut=>Hieracium kerneri
Gewöhnliches Habichtskraut=>Hieracium kuekenthalianum
Glattes Habichtskraut=>Hieracium lachenalii
Lorbeerartiges Habichtskraut=>Hieracium laevigatum
Weißgraues Habichtskraut=>Hieracium laurinum
Abgemagertes Habichtskraut=>Hieracium leucophaeum
Geflecktes Habichtskraut=>Hieracium macilentum
Schwarzdrüsiges Habichtskraut=>Hieracium maculatum
Misox-Habichtskraut=>Hieracium melanops
Wald-Habichtskraut=>Hieracium misaucinum
Schwärzliches Habichtskraut=>Hieracium murorum
Lotwurzblättriges Habichtskraut=>Hieracium nigrescens
Spitzzähniges Habichtskraut=>Hieracium onosmoides
Verbleichendes Habichtskraut=>Hieracium oxyodon
Bitterkrautartiges Habichtskraut=>Hieracium pallescens
Pietroszer Habichtskraut=>Hieracium picroides
Grauzottiges Habichtskraut=>Hieracium pietroszense
Wollköpfiges Habichtskraut=>Hieracium piliferum
Gestrecktes Habichtskraut=>Hieracium pilosum
Lauchblatt-Habichtskraut=>Hieracium porrectum
Hasenlattich-Habichtskraut=>Hieracium porrifolium
Prinz' Habichtskraut=>Hieracium prenanthoides
Promos-Habichtskraut=>Hieracium prinzii
Rapunzel-Habichtskraut=>Hieracium pseudodolichaetum
Vorarlberg-Habichtskraut=>Hieracium rapunculoides
Savoyer Habichtskraut=>Hieracium rohacsense
Felsen-Habichtskraut=>Hieracium sabaudum
Steinbrech-Habichtskraut=>Hieracium saxatile
Blasses Habichtskraut=>Hieracium saxifragum
Schwarzwurzelblättriges Habichtskraut=>Hieracium schmidtii
Gesägtblättriges Habichtskraut=>Hieracium scorzonerifolium
Nachäffendes Habichtskraut=>Hieracium serratum
Lockerästiges Habichtskraut=>Hieracium simia
Schmalfaltiges Habichtskraut=>Hieracium sparsiramum
Fastkahles Habichtskraut=>Hieracium stenoplecum
Doldiges Habichtskraut=>Hieracium subglaberrimum
Schattenliebendes Habichtskraut=>Hieracium umbellatum
Starkbehaartes Habichtskraut=>Hieracium umbrosum
Valodda-Habichtskraut=>Hieracium valdepilosum
Zottiges Habichtskraut=>Hieracium valoddae
Vollmanns Habichtskraut=>Hieracium villosum
Dünnstängeliges Habichtskraut=>Hieracium vollmannii
Wiesbaurs Habichtskraut=>Hieracium vulgatum
Wilczek-Habichtskraut=>Hieracium wiesbaurianum
Ochsenzungenblättriges Habichtskraut=>Hieracium wilczekianum
Garchinger Habichtskraut=>Hieracium anchusoides
Gletscher-Habichtskraut=>Hieracium aneimenum
Trockenheitsliebendes Habichtskraut=>Hieracium angustifolium
Lämmersalat-Habichtskraut=>Hieracium aridum
Rain-Habichtskraut=>Hieracium arnoserioides
Orangerotes Habichtskraut=>Hieracium arvicola
Pannonisches Habichtskraut=>Hieracium aurantiacum
Tiefgabeliges Habichtskraut=>Hieracium auriculoides
Ungarisches Habichtskraut=>Hieracium basifurcum
Gabelästiges Habichtskraut=>Hieracium bauhini
Kurzgabeliges Habichtskraut=>Hieracium brachiatum
Wiesen-Habichtskraut=>Hieracium brachycomum
Schönhaariges Habichtskraut=>Hieracium caespitosum
Grünfleckiges Habichtskraut=>Hieracium calodon
Aschgraues Habichtskraut=>Hieracium chlorops
Wimper-Habichtskraut=>Hieracium cinereiforme
Trugdoldiges Habichtskraut=>Hieracium cirritum
Dichtblütiges Habichtskraut=>Hieracium cymosum
Rötlichgelbes Habichtskraut=>Hieracium densiflorum
Trügerisches Habichtskraut=>Hieracium derubellum
Täuschendes Habichtskraut=>Hieracium fallacinum
Ausläuferreiches Habichtskraut=>Hieracium fallax
Reichblütiges Habichtskraut=>Hieracium flagellare
Fürnrohrs Habichtskraut=>Hieracium floribundum
Braunrötliches Habichtskraut=>Hieracium fuernrohrii
Dunkelbraunes Habichtskraut=>Hieracium fuscescens
Geknäueltköpfiges Habichtskraut=>Hieracium fuscum
Rötliches Habichtskraut=>Hieracium glomeratum
Hoppes Habichtskraut=>Hieracium guthnikianum
Schönköpfiges Habichtskraut=>Hieracium hoppeanum
Breitschuppiges Habichtskraut=>Hieracium hybridum
Isergebirgs-Habichtskraut=>Hieracium hypeuryum
Kalksburger Habichtskraut=>Hieracium iseranum
Geöhrtes Habichtskraut=>Hieracium kalksburgense
Dünnästiges Habichtskraut=>Hieracium lactucella
Zartes Habichtskraut=>Hieracium leptoclados
Leuker Habichtskraut=>Hieracium leptophyton
Langschuppiges Habichtskraut=>Hieracium leucense
Langläuferiges Habichtskraut=>Hieracium longisquamum
Großblütiges Habichtskraut=>Hieracium longistolonosum
Langläufer-Habichtskraut=>Hieracium macranthelum
Berg-Habichtskraut=>Hieracium macrostolonum
Schwarzkiel-Habichtskraut=>Hieracium montanum
Schnee-Habichtskraut=>Hieracium nigricarinum
Unechtes Habichtskraut=>Hieracium niphostribes
Weitschuppen-Habichtskraut=>Hieracium nothum
Irreführendes Habichtskraut=>Hieracium pachypilon
Peletiers Habichtskraut=>Hieracium paragogum
Peters Habichtskraut=>Hieracium peleterianum
Kleines Habichtskraut=>Hieracium peterianum
Mausohrähnliches Habichtskraut=>Hieracium pilosella
Florentiner Habichtskraut=>Hieracium pilosellinum
Peitschenläuferiges Habichtskraut=>Hieracium piloselloides
Preußisches Habichtskraut=>Hieracium polymastix
Falsches Wunder-Habichtskraut=>Hieracium prussicum
Rotes Habichtskraut=>Hieracium pseudomirabile
Skandinavisches Habichtskraut=>Hieracium rubrum
Schneids Habichtskraut=>Hieracium scandinavicum
Schultes Habichtskraut=>Hieracium schneidii
Schirmtragendes Habichtskraut=>Hieracium schultesii
Kugelköpfiges Habichtskraut=>Hieracium sciadophorum
Lockerrispiges Habichtskraut=>Hieracium sphaerocephalum
Läuferblütiges Habichtskraut=>Hieracium spurium
Schwefelgelbes Habichtskraut=>Hieracium stoloniflorum
Grünblättriges Habichtskraut=>Hieracium sulphureum
Visianis Habichtskraut=>Hieracium viridifolium
Ziz' Habichtskraut=>Hieracium visianii
Südliches Mariengras=>Hieracium zizianum
Rauhes Mariengras=>Hierochloe australis
Duftendes Mariengras=>Hierochloe hirta
Orientalische Riemenzunge=>Hierochloe odorata
Bocks-Riemenzunge=>Himantoglossum calcaratum
Schopfiger Hufeisenklee=>Himantoglossum hircinum
Strauch-Kronwicke=>Hippocrepis comosa
Sanddorn=>Hippocrepis emerus
Gewöhnlicher Tannenwedel=>Hippophae rhamnoides
Grausenf=>Hippuris vulgaris
Wolliges Honiggras=>Hirschfeldia incana
Weiches Honiggras=>Holcus lanatus
Schaumspiere=>Holcus mollis
Doldige Spurre=>Holodiscus discolor
Grüner Alpenlattich=>Holosteum umbellatum
Filziger Alpenlattich=>Homogyne alpina
Wald-Haargerste=>Homogyne discolor
Mähnen-Gerste=>Hordelymus europaeus
Mäuse-Gerste=>Hordeum jubatum
Roggen-Gerste=>Hordeum murinum
Saat-Gerste=>Hordeum secalinum
Pyrenäen-Drachenmaul=>Hordeum vulgare
Kleine Felskresse=>Horminum pyrenaicum
Glockenfunkie=>Hornungia petraea
Europäische Wasserfeder=>Hosta ventricosa
Gewöhnlicher Hopfen=>Hottonia palustris
Japanischer Hopfen=>Humulus lupulus
Tannen-Bärlapp=>Humulus scandens
Hasenglöckchen=>Huperzia selago
Hyazinthe=>Hyacinthoides non-scripta
Europäischer Froschbiss=>Hyacinthus orientalis
Gewöhnlicher Wassernabel=>Hydrocharis morsus-ranae
Schwarzes Bilsenkraut=>Hydrocotyle vulgaris
Sumpf-Johanniskraut=>Hyoscyamus niger
Behaartes Johanniskraut=>Hypericum elodes
Niederliegendes Johanniskraut=>Hypericum hirsutum
Geflecktes Johanniskraut=>Hypericum humifusum
Großes Kanadisches Johanniskraut=>Hypericum maculatum
Berg-Johanniskraut=>Hypericum majus
Tüpfel-Johanniskraut=>Hypericum montanum
Schönes Johanniskraut=>Hypericum perforatum
Geflügeltes Johanniskraut=>Hypericum pulchrum
Kahles Ferkelkraut=>Hypericum tetrapterum
Geflecktes Ferkelkraut=>Hypochaeris glabra
Gewöhnliches Ferkelkraut=>Hypochaeris maculata
Robertis Ferkelkraut=>Hypochaeris radicata
Einköpfiges Ferkelkraut=>Hypochaeris robertia
Arznei-Ysop=>Hypochaeris uniflora
Bittere Schleifenblume=>Hyssopus officinalis
Leinblättrige Schleifenblume=>Iberis amara
Gefiederte Schleifenblume=>Iberis linifolia
Immergrüne Schleifenblume=>Iberis pinnata
Doldige Schleifenblume=>Iberis sempervirens
Gewöhnliche Stechpalme=>Iberis umbellata
Knorpelkraut=>Ilex aquifolium
Orangerotes Springkraut=>Illecebrum verticillatum
Drüsiges Springkraut=>Impatiens capensis
Großes Springkraut=>Impatiens glandulifera
Kleines Springkraut=>Impatiens noli-tangere
Wiesen-Alant=>Impatiens parviflora
Dürrwurz, Strahlenloser Alant=>Inula britannica
Schwert-Alant=>Inula conyzae
Deutscher Alant=>Inula ensifolia
Echter Alant=>Inula germanica
Rauhhaariger Alant=>Inula helenium
Weidenblättriger Alant=>Inula hirta
Frühlingsstern=>Inula salicina
Bunte Gartenwinde=>Ipheion uniflorum
Deutsche Schwertlilie=>Ipomoea purpurea
Grasblättrige Schwertlilie=>Iris germanica
Sumpf-Schwertlilie=>Iris graminea
Zwerg-Schwertlilie=>Iris pseudacorus
Holunder-Schwertlilie=>Iris pumila
Gelbliche Schwertlilie=>Iris sambucina
Sibirische Schwertlilie=>Iris squalens
Bunte Schwertlilie=>Iris sibirica
Färber-Waid=>Iris variegata
See-Brachsenkraut=>Isatis tinctoria
FEHLER: ['Borstige Moorbinse', '', 'Iso\xc3\xabtes lacustris']
Schlagkraut=>Isolepis setacea
Berg-Sandglöckchen=>Iva xanthiifolia
Sand-Donarsbart=>Jasione montana
Fransen-Hauswurz=>Jovibarba arenaria
Schwarznuss=>Jovibarba globifera
Walnuss=>Juglans nigra
Spitzblütige Binse=>Juglans regia
Alpen-Binse=>Juncus acutiflorus
Glieder-Binse=>Juncus alpinus
Schwarze Binse=>Juncus articulatus
Kröten-Binse=>Juncus atratus
Frosch-Binse=>Juncus bufonius
Rasen-Binse=>Juncus ranarius
Kopf-Binse=>Juncus bulbosus
Zusammengedrückte Binse=>Juncus capitatus
Bodden-Binse=>Juncus compressus
Knäuel-Binse=>Juncus gerardii
Dudleys Binse=>Juncus conglomeratus
Flatter-Binse=>Juncus dudleyi
Schwertblättrige Binse=>Juncus effusus
Faden-Binse=>Juncus ensifolius
Blaugrüne Binse=>Juncus filiformis
Gemsen-Binse=>Juncus inflexus
Kugelfrüchtige Binse=>Juncus jacquinii
Sparrige Binse=>Juncus sphaerocarpus
Moor-Binse=>Juncus squarrosus
Stumpfblütige Binse=>Juncus stygius
Sand-Binse=>Juncus subnodulosus
Zarte Binse=>Juncus tenageia
Dreispaltige Binse=>Juncus tenuis
Dreiblütige Binse=>Juncus trifidus
Heide-Wacholder=>Juncus triglumis
Sadebaum=>Juniperus communis
Virginischer Wacholder=>Juniperus sabina
Sand-Silberscharte=>Juniperus virginiana
Schmalblättrige Lorbeerrose=>Jurinea cyanoides
Felsen-Kugelschötchen=>Kalmia angustifolia
Ranunkelstrauch=>Kernera saxatilis
Spießblättriges Tännelkraut=>Kerria japonica
Eiblättriges Tännelkraut=>Kickxia elatine
Balkan-Malve=>Kickxia spuria
Wiesen-Witwenblume=>Kitaibela vitifolia
Wald-Witwenblume=>Knautia arvensis
Nacktried=>Knautia dipsacifolia
Schuppenried=>Kobresia myosuroides
Zierliches Schillergras=>Kobresia simpliciuscula
Großes Schillergras=>Koeleria macrantha
Rispiger Blasenbaum=>Koeleria pyramidata
Perlmuttstrauch=>Koelreuteria paniculata
Alpen-Goldregen=>Kolkwitzia amabilis
Gewöhnlicher Goldregen=>Laburnum alpinum
Blauer Lattich=>Laburnum anagyroides
Eichen-Lattich=>Lactuca perennis
Weidenblättriger Lattich=>Lactuca quercina
Garten-Lattich=>Lactuca saligna
Kompass-Lattich=>Lactuca sativa
Gift-Lattich=>Lactuca serriola
Wechselblatt-Wasserpest=>Lactuca virosa
Hasenschwänzchen=>Lagarosiphon major
Weiße Taubnessel=>Lagurus ovatus
Stängelumfassende Taubnessel=>Lamium album
Zweispaltige Taubnessel=>Lamium amplexicaule
Silber-Goldnessel=>Lamium bifidum
Endtmanns Goldnessel=>Lamium argentatum
Blassgelbe Goldnessel=>Lamium endtmannii
Berg-Goldnessel=>Lamium flavidum
Gefleckte Taubnessel=>Lamium montanum
Purpurrote Taubnessel=>Lamium maculatum
Kanadische Strauchnessel=>Lamium purpureum
Wald-Igelsame=>Laportea canadensis
Kletten-Igelsame=>Lappula deflexa
Gewöhnlicher Rainkohl=>Lappula squarrosa
Europäische Lärche=>Lapsana communis
Japanische Lärche=>Larix decidua
Dreilappiger Rosskümmel=>Larix kaempferi
Breitblättriges Laserkraut=>Laser trilobum
Preußisches Laserkraut=>Laserpitium latifolium
Berg-Laserkraut=>Laserpitium prutenicum
Niedrige Schuppenwurz=>Laserpitium siler
Gewöhnliche Schuppenwurz=>Lathraea clandestina
Ranken-Platterbse=>Lathraea squamaria
Kicher-Platterbse=>Lathyrus aphaca
Purpurne Platterbse=>Lathyrus cicera
Verschiedenblättrige Platterbse=>Lathyrus clymenum
Behaarte Platterbse=>Lathyrus heterophyllus
Kleinblütige Platterbse=>Lathyrus hirsutus
Gelbe Platterbse=>Lathyrus inconspicuus
Breitblättrige Platterbse=>Lathyrus laevigatus
Berg-Platterbse=>Lathyrus latifolius
Schwarzwerdende Platterbse=>Lathyrus linifolius
Gras-Platterbse=>Lathyrus niger
Duftende Platterbse=>Lathyrus nissolia
Sumpf-Platterbse=>Lathyrus odoratus
Wiesen-Platterbse=>Lathyrus palustris
Saat-Platterbse=>Lathyrus pratensis
Kugelsamige Platterbse=>Lathyrus sativus
Wald-Platterbse=>Lathyrus sphaericus
Knollen-Platterbse=>Lathyrus sylvestris
Venezianische Platterbse=>Lathyrus tuberosus
Frühlings-Platterbse=>Lathyrus venetus
Lorbeer=>Lathyrus vernus
Echter Lavendel=>Laurus nobilis
Thüringer Strauchpappel=>Lavandula angustifolia
Bechermalve=>Lavatera thuringiaca
Sumpf-Porst=>Lavatera trimestris
Europäische Reisquecke=>Ledum palustre
Kleiner Frauenspiegel=>Leersia oryzoides
Gewöhnlicher Frauenspiegel=>Legousia hybrida
Buckelige Wasserlinse=>Legousia speculum-veneris
Kleine Wasserlinse=>Lemna gibba
Zierliche Wasserlinse=>Lemna minor
Dreifurchige Wasserlinse=>Lemna minuta
Rote Wasserlinse=>Lemna trisulca
Linse=>Lemna turionifera
Wild-Linse=>Lens culinaris
Herbst-Löwenzahn=>Lens nigricans
Schweizer Löwenzahn=>Leontodon autumnalis
Rauhhaar-Löwenzahn=>Leontodon helveticus
Grauer Löwenzahn=>Leontodon hispidus
Berg-Löwenzahn=>Leontodon incanus
Nickender Löwenzahn=>Leontodon montanus
Alpen-Edelweiß=>Leontodon saxatilis
Echtes Herzgespann=>Leontopodium alpinum
Mittleres Herzgespann=>Leonurus cardiaca
Filziges Herzgespann=>Leonurus intermedius
Feld-Kresse=>Leonurus marrubiastrum
Dichtblütige Kresse=>Lepidium campestre
Grasblättrige Kresse=>Lepidium densiflorum
Verschiedenblättrige Kresse=>Lepidium graminifolium
Behaarte Kresse=>Lepidium heterophyllum
Breitblättrige Kresse=>Lepidium hirtum
Verkannte Kresse=>Lepidium latifolium
Durchwachsene Kresse=>Lepidium neglectum
Schutt-Kresse=>Lepidium perfoliatum
Gartenkresse=>Lepidium ruderale
Virginische Kresse=>Lepidium sativum
Blasenmiere=>Lepidium virginicum
Spätblühende Margerite=>Lepyrodiclis holosteoides
Alpen-Margerite=>Leucanthemella serotina
Hallers Wucherblume=>Leucanthemopsis alpina
Berg-Wucherblume=>Leucanthemum halleri
Fettwiesen-Margerite=>Leucanthemum adustum
Garten-Margerite=>Leucanthemum ircutianum
Magerwiesen-Margerite=>Leucanthemum maximum
Sommer-Knotenblume=>Leucanthemum vulgare
Märzenbecher, Frühlings-Knotenblume=>Leucojum aestivum
Liebstöckel=>Leucojum vernum
Dünen-Strandroggen=>Levisticum officinale
Przewalski-Goldkolben=>Leymus arenarius
Alpen-Mutterwurz=>Ligularia przewalskii
Kleine Mutterwurz=>Ligusticum mutellina
Ovalblättriger Liguster=>Ligusticum mutellinoides
Gewöhnlicher Liguster=>Ligustrum ovalifolium
Feuer-Lilie=>Ligustrum vulgare
Krainer Lilie=>Lilium bulbiferum
Türkenbund-Lilie=>Lilium carniolicum
Breitblättriger Strandflieder=>Lilium martagon
Gewöhnlicher Schlammling=>Limonium gerberi
Alpen-Leinkraut=>Limosella aquatica
Acker-Leinkraut=>Linaria alpina
Dalmatiner Leinkraut=>Linaria arvensis
Ginster-Leinkraut=>Linaria dalmatica
Fleischfarbenes Leinkraut=>Linaria genistifolia
Purpur-Leinkraut=>Linaria incarnata
Gestreiftes Leinkraut=>Linaria purpurea
Niedriges Leinkraut=>Linaria repens
Gewöhnliches Leinkraut=>Linaria supina
Großes Büchsenkraut=>Linaria vulgaris
Liegendes Büchsenkraut=>Lindernia dubia
Moosglöckchen=>Lindernia procumbens
Purgier-Lein=>Linnaea borealis
Gelber Lein=>Linum catharticum
Roter Lein=>Linum flavum
Alpen-Lein=>Linum grandiflorum
Österreichischer Lein=>Linum alpinum
Lothringer Lein=>Linum austriacum
Ausdauernder Lein=>Linum leonii
Schmalblättriger Lein=>Linum perenne
Flachs=>Linum tenuifolium
Klebriger Lein=>Linum usitatissimum
Sumpf-Glanzkraut=>Linum viscosum
Kleines Zweiblatt=>Liparis loeselii
Großes Zweiblatt=>Listera cordata
Acker-Steinsame=>Listera ovata
Echter Steinsame=>Lithospermum arvense
Blauroter Steinsame=>Lithospermum officinale
Europäischer Strandling=>Lithospermum purpurocaeruleum
Späte Faltenlilie=>Littorella uniflora
Blaue Lobelie=>Lloydia serotina
Blaue Kardinalslobelie=>Lobelia erinus
Strand-Silberkraut=>Lobelia siphilitica
Alpen-Azalee=>Lobularia maritima
Vielblütiges Weidelgras=>Loiseleuria procumbens
Ausdauerndes Weidelgras=>Lolium multiflorum
Steif-Lolch=>Lolium perenne
Lein-Lolch=>Lolium rigidum
Taumel-Lolch=>Lolium remotum
Kärntner Tauernblümchen=>Lolium temulentum
Gelber Leberbalsam=>Lomatogonium carinthiacum
Alpen-Heckenkirsche=>Lonas annua
Blaue Heckenkirsche=>Lonicera alpigena
Wohlriechendes Geißblatt=>Lonicera caerulea
Behüllte Heckenirsche=>Lonicera caprifolium
Japanische Heckenkirsche=>Lonicera involucrata
Schwarze Heckenkirsche=>Lonicera japonica
Immergrüne Heckenkirsche=>Lonicera nigra
Wald-Geißblatt=>Lonicera nitida
Kriechende Heckenkirsche=>Lonicera periclymenum
Tatarische Heckenkirsche=>Lonicera pileata
Rote Heckenkirsche=>Lonicera tatarica
Alpen-Hornklee=>Lonicera xylosteum
Gewöhnlicher Hornklee=>Lotus alpinus
Schmalblättriger Hornklee=>Lotus corniculatus
Sumpf-Hornklee=>Lotus tenuis
Garten-Silberblatt=>Lotus pedunculatus
Wildes Silberblatt=>Lunaria annua
Weiße Lupine=>Lunaria rediviva
Blaue Lupine=>Lupinus albus
Gelbe Lupine=>Lupinus angustifolius
Vielblättrige Lupine=>Lupinus luteus
Froschkraut=>Lupinus polyphyllus
Braune Hainsimse=>Luronium natans
Alpen-Hainsimse=>Luzula alpinopilosa
Feld-Hainsimse=>Luzula alpina
Schlanke Feld-Hainsimse=>Luzula campestris
Vielblütige Hainsimse=>Luzula divulgata
Bleiche Hainsimse=>Luzula multiflora
Sudeten-Hainsimse=>Luzula pallidula
Forsters Hainsimse=>Luzula sudetica
Kahle Hainsimse=>Luzula forsteri
Gelbliche Hainsimse=>Luzula glabrata
Busch-Hainsimse=>Luzula luzulina
Schnee-Hainsimse=>Luzula luzuloides
Behaarte Hainsimse=>Luzula nivea
Ähren-Hainsimse=>Luzula pilosa
Wald-Hainsimse=>Luzula spicata
Gewöhnlicher Bocksdorn=>Luzula sylvatica
Chinesischer Bocksdorn=>Lycium barbarum
Tomate=>Lycium chinense
Sumpf-Bärlapp=>Lycopersicon esculentum
Sprossender Bärlapp=>Lycopodiella inundata
Keulen-Bärlapp=>Lycopodium annotinum
Ufer-Wolfstrapp=>Lycopodium clavatum
Hoher Wolfstrapp=>Lycopus europaeus
Hain-Gilbweiderich=>Lycopus exaltatus
Pfennig-Gilbweiderich=>Lysimachia nemorum
Punktierter Gilbweiderich=>Lysimachia nummularia
Straußblütiger Gilbweiderich=>Lysimachia punctata
Gewöhnlicher Gilbweiderich=>Lysimachia thyrsiflora
Ysopblättriger Weiderich=>Lysimachia vulgaris
Binsen-Weiderich=>Lythrum hyssopifolia
Blut-Weiderich=>Lythrum junceum
Federmohn=>Lythrum salicaria
Gewöhnliche Mahonie=>Macleaya cordata
Zweiblättriges Schattenblümchen=>Mahonia aquifolium
Majoran=>Maianthemum bifolium
Zartes Einblatt=>Majorana hortensis
Strand-Levkoje=>Malaxis monophyllos
Trichtermalve=>Malcolmia maritima
Garten-Apfel=>Malope trifida
Holz-Apfel=>Malus domestica
Rosen-Malve=>Malus sylvestris
Moschus-Malve=>Malva alcea
Weg-Malve=>Malva moschata
Nizza-Malve=>Malva neglecta
Kleinblütige Malve=>Malva nicaeensis
Kleine Malve=>Malva parviflora
Wilde Malve=>Malva pusilla
Quirl-Malve=>Malva sylvestris
Gewöhnlicher Andorn=>Malva verticillata
Vierblättriger Kleefarn=>Marrubium vulgare
Strahlenlose Kamille=>Marsilea quadrifolia
Echte Kamille=>Matricaria discoidea
Straußfarn=>Matricaria recutita
Levkoje=>Matteuccia struthiopteris
Sumpf-Margerite=>Matthiola incana
Gelber Scheinmohn=>Mauranthemum paludosum
Arabischer Schneckenklee=>Meconopsis cambrica
Ufer-Schneckenklee=>Medicago arabica
Hopfen-Schneckenklee=>Medicago littoralis
Zwerg-Schneckenklee=>Medicago lupulina
Rauer Schneckenklee=>Medicago minima
Sichel-Schneckenklee=>Medicago polymorpha
Acker-Wachtelweizen=>Medicago falcata
Kamm-Wachtelweizen=>Melampyrum arvense
Hain-Wachtelweizen=>Melampyrum cristatum
Wiesen-Wachtelweizen=>Melampyrum nemorosum
Wald-Wachtelweizen=>Melampyrum pratense
Hohes Perlgras=>Melampyrum sylvaticum
Wimper-Perlgras=>Melica altissima
Siebenbürgisches Perlgras=>Melica ciliata
Nickendes Perlgras=>Melica transsilvanica
Buntes Perlgras=>Melica nutans
Einblütiges Perlgras=>Melica picta
Weißer Steinklee=>Melica uniflora
Hoher Steinklee=>Melilotus albus
Gezähnter Steinklee=>Melilotus altissimus
Kleinblütiger Steinklee=>Melilotus dentatus
Gewöhnlicher Steinklee=>Melilotus indicus
Gefurchtfrüchtiger Steinklee=>Melilotus officinalis
Zitronen-Melisse=>Melilotus sulcatus
Minzenblättriges Immenblatt=>Melissa officinalis
Wasser-Minze=>Melittis melissophyllum
Acker-Minze=>Mentha aquatica
Polei-Minze=>Mentha arvensis
Ross-Minze=>Mentha pulegium
Grüne Minze=>Mentha longifolia
Rundblättrige Minze=>Mentha spicata
Fieberklee=>Mentha suaveolens
Einjähriges Bingelkraut=>Menyanthes trifoliata
Eiblättriges Bingelkraut=>Mercurialis annua
Wald-Bingelkraut=>Mercurialis ovata
Knotenblütige Mittagsblume=>Mercurialis perennis
Echte Mispel=>Mesembryanthemum nodiflorum
Gewöhnliche Bärwurz=>Mespilus germanica
Sand-Zwerggras=>Meum athamanticum
Flattergras=>Mibora minima
Gelbe Gauklerblume=>Milium effusum
Moschus-Gauklerblume=>Mimulus guttatus
Gauklerblume=>Mimulus moschatus
Österreichische Miere=>Mimulus ringens
Polster-Miere=>Minuartia austriaca
Schmalblättrige Miere=>Minuartia cherlerioides
Büschel-Miere=>Minuartia hybrida
Felsen-Miere=>Minuartia rubra
Zwerg-Miere=>Minuartia rupestris
Borsten-Miere=>Minuartia sedoides
Steife Miere=>Minuartia setacea
Frühlings-Miere=>Minuartia stricta
Klebrige Miere=>Minuartia verna
Wunderblume=>Minuartia viscosa
Silberfahnengras, Zucker-Chinaschilf=>Mirabilis jalapa
Gewöhnliches Chinaschilf=>Miscanthus sacchariflorus
Acker-Löwenmaul=>Miscanthus sinensis
Gewimperte Nabelmiere=>Misopates orontium
Moos-Nabelmiere=>Moehringia ciliata
Dreinervige Nabelmiere=>Moehringia muscosa
Aufrechte Weißmiere=>Moehringia trinervia
Rohr-Pfeifengras=>Moenchia erecta
Gewöhnliches Pfeifengras=>Molinia arundinacea
Muschelblume=>Molinia caerulea
Einblütiges Wintergrün=>Moluccella laevis
Buchenspargel=>Moneses uniflora
Fichtenspargel=>Monotropa hypophegea
Bach-Quellkraut=>Monotropa hypopitys
Weiße Maulbeere=>Montia fontana
Schwarze Maulbeere=>Morus alba
Wiesen-Mühlenbergie=>Morus nigra
Armenische Traubenhyazinthe=>Muhlenbergia mexicana
Kleine Traubenhyazinthe=>Muscari armeniacum
Schopfige Traubenhyazinthe=>Muscari botryoides
Weinberg-Traubenhyazinthe=>Muscari comosum
Schmalblütige Traubenhyazinthe=>Muscari neglectum
Hohldotter=>Muscari tenuiflorum
Gewöhnlicher Mauerlattich=>Myagrum perfoliatum
Acker-Vergissmeinnicht=>Mycelis muralis
Buntes Vergissmeinnicht=>Myosotis arvensis
Hügel-Vergissmeinnicht=>Myosotis discolor
Rasen-Vergissmeinnicht=>Myosotis ramosissima
Hain-Vergissmeinnicht=>Myosotis laxa
Bodensee-Vergissmeinnicht=>Myosotis nemorosa
Zerstreutblütiges Vergissmeinnicht=>Myosotis rehsteineri
Sand-Vergissmeinnicht=>Myosotis sparsiflora
Alpen-Vergissmeinnicht=>Myosotis stricta
Niederliegendes Vergissmeinnicht=>Myosotis alpestris
Wald-Vergissmeinnicht=>Myosotis decumbens
Mäuseschwänzchen=>Myosotis sylvatica
Deutsche Tamariske=>Myosurus minimus
Wechselblütiges Tausendblatt=>Myricaria germanica
Ähriges Tausendblatt=>Myriophyllum alterniflorum
Quirliges Tausendblatt=>Myriophyllum spicatum
Alpen-Süßdolde=>Myriophyllum verticillatum
Blasenstengel=>Myrrhis odorata
Großes Nixenkraut=>Myrrhoides nodosa
Kleines Nixenkraut=>Najas marina
Wilde Narzisse=>Najas minor
Dichter-Narzisse=>Narcissus minor
Gelbe Narzisse=>Narcissus poeticus
Borstgras=>Narcissus pseudonarcissus
Kleinblättrige Brunnenkresse=>Nardus stricta
Echte Brunnenkresse=>Nasturtium microphyllum
Weiße Navarretia=>Nasturtium officinale
Sparrige Navarretie=>Navarretia leucocephala
Vogel-Nestwurz=>Navarretia squarrosa
Gewöhnliche Katzenminze=>Neottia nidus-avis
Großblütige Katzenminze=>Nepeta cataria
Pannonische Katzenminze=>Nepeta grandiflora
Traubige Katzenminze=>Nepeta nuda
Rispen-Finkensame=>Nepeta racemosa
Giftbeere=>Neslia paniculata
Zier-Tabak=>Nicandra physaloides
Brasilianischer Tabak=>Nicotiana alata
Bauern-Tabak=>Nicotiana langsdorffii
Duft-Tabak=>Nicotiana rustica
Virginischer Tabak=>Nicotiana sylvestris
Acker-Schwarzkümmel=>Nicotiana tabacum
Damaszener Schwarzkümmel=>Nigella arvensis
Saat-Schwarzkümmel=>Nigella damascena
Dolomiten-Kohlröschen=>Nigella sativa
Rotes Kohlröschen=>Nigritella dolomitensis
Schwarzes Kohlröschen=>Nigritella miniata
Schwarzes Kohlröschen=>Nigritella nigra
Widders Kohlröschen=>Nigritella rhellicani
Gelbes Mönchskraut=>Nigritella widderi
Braunes Mönchskraut=>Nonea lutea
Rosenrotes Mönchskraut=>Nonea pulla
Gelbe Teichrose=>Nonea rosea
Kleine Teichrose=>Nuphar lutea
Weiße Seerose=>Nuphar pumila
Glänzende Seerose=>Nymphaea alba
Seekanne=>Nymphaea candida
Basilikum=>Nymphoides peltata
Gelber Zahntrost=>Ocimum basilicum
Frühlings-Zahntrost=>Odontites luteus
Roter Zahntrost=>Odontites vernus
Großer Wasserfenchel=>Odontites vulgaris
Röhriger Wasserfenchel=>Oenanthe aquatica
Haarstrangblättriger Wasserfenchel=>Oenanthe fistulosa
Behaarte Nachtkerze=>Oenanthe peucedanifolia
Missouri-Nachtkerze=>Oenothera pilosella
Graugrüne Nachtkerze=>Oenothera macrocarpa
Weidenblättrige Nachtkerze=>Oenothera canovirens
Steife Nachtkerze=>Oenothera depressa
Graublättrige Nachtkerze=>Oenothera elata
Danziger Nachtkerze=>Oenothera villosa
Weißsamtige Nachtkerze=>Oenothera wienii
Zweijährige Nachtkerze=>Oenothera albivelutina
Abgebogene Nachtkerze=>Oenothera biennis
Ersteiner Nachtkerze=>Oenothera deflexa
Täuschende Nachtkerze=>Oenothera ersteinensis
Fläming-Nachtkerze=>Oenothera fallax
Rotkelchige Nachtkerze=>Oenothera flaemingina
Hoelscher-Nachtkerze=>Oenothera glazioviana
Kahle Nachtkerze=>Oenothera hoelscheri
Oehlker-Nachtkerze=>Oenothera nuda
Dichtfrüchtige Nachtkerze=>Oenothera oehlkersi
Royfraser-Nachtkerze=>Oenothera pycnocarpa
Rotstängelige Nachtkerze=>Oenothera royfraseri
Schnedlers Nachtkerze=>Oenothera rubricaulis
Stucchis Nachtkerze=>Oenothera schnedleri
Duftende Nachtkerze=>Oenothera stucchii
Victorin-Nachtkerze=>Oenothera suaveolens
Weiße Hybrid-Nachtkerze=>Oenothera victorini
Schmalblättrige Nachtkerze=>Oenothera albisubcurva
Braun-Nachtkerze=>Oenothera angustissima
Hazels Nachtkerze=>Oenothera braunii
Issler-Nachtkerze=>Oenothera hazelae
Küsten-Nachtkerze=>Oenothera issleri
Kleinblütige Nachtkerze=>Oenothera oakesiana
Rote Hybrid-Nachtkerze=>Oenothera parviflora
Schlesische Nachtkerze=>Oenothera rubrisubcurva
Wald-Nabelnüsschen=>Oenothera subterminalis
Frühlings-Nabelnüsschen=>Omphalodes scorpioides
Sand-Esparsette=>Omphalodes verna
Berg-Esparsette=>Onobrychis arenaria
Futter-Esparsette=>Onobrychis montana
Weiche Hauhechel=>Onobrychis viciifolia
Bocks-Hauhechel=>Ononis mitissima
Kriechende Hauhechel=>Ononis arvensis
Dornige Hauhechel=>Ononis repens
Gewöhnliche Eselsdistel=>Ononis spinosa
Gewöhnliche Natternzunge=>Onopordum acanthium
Bienen-Ragwurz=>Ophioglossum vulgatum
Hummel-Ragwurz=>Ophrys apifera
Fliegen-Ragwurz=>Ophrys holoserica
Kleine Spinnen-Ragwurz=>Ophrys insectifera
Gewöhnliche Spinnen-Ragwurz=>Ophrys araneola
Wanzen-Knabenkraut=>Ophrys sphegodes
Männliches Knabenkraut=>Orchis coriophora
Helm-Knabenkraut=>Orchis mascula
Kleines Knabenkraut=>Orchis militaris
Blasses Knabenkraut=>Orchis morio
Sumpf-Knabenkraut=>Orchis pallens
Purpur-Knabenkraut=>Orchis palustris
Dreizähniges Knabenkraut=>Orchis purpurea
Brand-Knabenkraut=>Orchis tridentata
Zweizeiliges Blaugras=>Orchis ustulata
Bergfarn=>Oreochloa disticha
Gewöhnlicher Dost=>Oreopteris limbosperma
Strahlen-Breitsame=>Origanum vulgare
Grüner Milchstern=>Orlaya grandiflora
Nickender Milchstern=>Ornithogalum boucheanum
Schmalblättriger Milchstern=>Ornithogalum nutans
Gewöhnlicher Dolden-Milchstern=>Ornithogalum angustifolium
Kleiner Vogelfuß=>Ornithogalum vulgare
Großer Vogelfuß=>Ornithopus perpusillus
Quendel-Sommerwurz=>Ornithopus sativus
Elsässer Sommerwurz=>Orobanche alba
Amethyst-Sommerwurz=>Orobanche alsatica
Sand-Sommerwurz=>Orobanche amethystea
Bitterkraut-Sommerwurz=>Orobanche arenaria
Nelken-Sommerwurz=>Orobanche picridis
Bläuliche Sommerwurz=>Orobanche caryophyllacea
Große Sommerwurz=>Orobanche coerulescens
Hellgelbe Sommerwurz=>Orobanche elatior
Blutrote Sommerwurz=>Orobanche flava
Efeu-Sommerwurz=>Orobanche gracilis
Berberitzen-Sommerwurz=>Orobanche hederae
Gelbe Sommerwurz=>Orobanche lucorum
Kleine Sommerwurz=>Orobanche lutea
Violette Sommerwurz=>Orobanche minor
Ästige Sommerwurz=>Orobanche purpurea
Distel-Sommerwurz=>Orobanche ramosa
Salbei-Sommerwurz=>Orobanche reticulata
Gamander-Sommerwurz=>Orobanche salviae
Nickendes Wintergrün=>Orobanche teucrii
Grannenreis=>Orthilia secunda
Königsfarn=>Oryzopsis paradoxa
Wald-Sauerklee=>Osmunda regalis
Hornfrüchtiger Sauerklee=>Oxalis acetosella
Rosa Sauerklee=>Oxalis corniculata
Dillenius' Sauerklee=>Oxalis debilis
Breitblättriger Sauerklee=>Oxalis dillenii
Aufrechter Sauerklee=>Oxalis latifolia
Glücksklee=>Oxalis stricta
Buganville=>Oxalis tetraphylla
Alpen-Säuerling=>Oxybaphus nyctagineus
Berg-Fahnenwicke=>Oxyria digyna
Zottige Fahnenwicke=>Oxytropis jacquinii
Japanischer Ysander=>Oxytropis pilosa
Garten-Pfingstrose=>Pachysandra terminalis
Bartpolster-Hirse=>Paeonia officinalis
Haarästige Hirse=>Panicum barbipulvinatum
Hillmans Hirse=>Panicum capillare
Gabelästige Hirse=>Panicum hillmanii
Rispen-Hirse=>Panicum dichotomiflorum
Glattblättrige Hirse=>Panicum miliaceum
Rotbraunblättrige Rutenhirse=>Panicum schinzii
Alpen-Mohn=>Panicum virgatum
Sand-Mohn=>Papaver alpinum
Saat-Mohn=>Papaver argemone
Bastard-Mohn=>Papaver dubium
Islandmohn=>Papaver hybridum
Türkischer Mohn, Gartenmohn=>Papaver nudicaule
Behaarter Mohn=>Papaver orientale
Gefiederter Mohn=>Papaver pilosum
Orientalischer Mohn=>Papaver pinnatifidum
Klatsch-Mohn=>Papaver pseudoorientale
Schlaf-Mohn=>Papaver rhoeas
Mauer-Glaskraut=>Papaver somniferum
Aufrechtes Glaskraut=>Parietaria judaica
Vierblättrige Einbeere=>Parietaria officinalis
Sumpf-Herzblatt=>Paris quadrifolia
Haftender Wilder Wein=>Parnassia palustris
Fünfblättriger Wilder Wein=>Parthenocissus inserta
Dreispitzige Jungfernrebe=>Parthenocissus quinquefolia
Pastinak=>Parthenocissus tricuspidata
Chinesischer Blauglockenbaum=>Pastinaca sativa
Durchblättertes Läusekraut=>Paulownia tomentosa
Buntes Läusekraut=>Pedicularis foliosa
Sumpf-Läusekraut=>Pedicularis oederi
Gestutztes Läusekraut=>Pedicularis palustris
Geschnäbeltes Läusekraut=>Pedicularis recutita
Fleischrotes Läusekraut=>Pedicularis rostratocapitata
Karlszepter-Läusekraut=>Pedicularis rostratospicata
Wald-Läusekraut=>Pedicularis sceptrum-carolinum
Quirlblättriges Läusekraut=>Pedicularis sylvatica
Portulak-Sumpfquendel=>Pedicularis verticillata
Cinerarie=>Peplis portula
Fiederschnittige Perowskie=>Pericallis tussilaginis
Wasser-Knöterich=>Perovskia abrotanoides
Milder Knöterich=>Persicaria amphibia
Wasserpfeffer-Knöterich=>Persicaria dubia
Ampfer-Knöterich=>Persicaria hydropiper
Floh-Knöterich=>Persicaria lapathifolia
Kleiner Knöterich=>Persicaria maculosa
Orient-Knöterich=>Persicaria minor
Weiße Pestwurz=>Persicaria orientalis
Gewöhnliche Pestwurz=>Petasites albus
Alpen-Pestwurz=>Petasites hybridus
Alpen-Steinschmückel=>Petasites paradoxus
Sprossende Felsennelke=>Petrocallis pyrenaica
Steinbrech-Felsennelke=>Petrorhagia prolifera
Petersilie=>Petrorhagia saxifraga
Elsässer Haarstrang=>Petroselinum crispum
Kümmelblättriger Haarstrang=>Peucedanum alsaticum
Hirsch-Haarstrang=>Peucedanum carvifolia
Arznei-Haarstrang=>Peucedanum cervaria
Berg-Haarstrang=>Peucedanum officinale
Meisterwurz, Kaiser-Haarstrang=>Peucedanum oreoselinum
Sumpf-Haarstrang=>Peucedanum ostruthium
Riesen-Haarstrang=>Peucedanum palustre
Rainfarn-Phazelie=>Peucedanum verticillare
Rohr-Glanzgras=>Phacelia tanacetifolia
Echtes Glanzgras=>Phalaris arundinacea
Kleines Glanzgras=>Phalaris canariensis
Sonderbares Glanzgras=>Phalaris minor
Feuer-Bohne=>Phalaris paradoxa
Gartenbohne=>Phaseolus coccineus
Buchenfarn=>Phaseolus vulgaris
Falscher Jasmin=>Phegopteris connectilis
Alpen-Lieschgras=>Philadelphus coronarius
Graubündener Lieschgras=>Phleum alpinum
Matten-Lieschgras=>Phleum rhaeticum
Rauhes Lieschgras=>Phleum hirsutum
Steppen-Lieschgras=>Phleum paniculatum
Knolliges Lieschgras=>Phleum phleoides
Wiesen-Lieschgras=>Phleum bertolonii
Pfriemliches Lieschgras=>Phleum pratense
Stauden-Phlox=>Phleum subulatum
Polster-Phlox=>Phlox paniculata
Dattel-Palme=>Phlox subulata
Schilf=>Phoenix dactylifera
Rosenwaldmeister=>Phragmites australis
Gartenbambus=>Phuopsis stylosa
Gewöhnliche Blasenkirsche=>Phyllostachys bambusoides
Kapstachelbeere=>Physalis alkekengi
Hülsentomate=>Physalis peruviana
Behaarte Blasenkirsche=>Physalis philadelphica
Schneeballblättriger Spierstrauch=>Physalis pubescens
Blasendolde=>Physocarpus opulifolius
Gelenkblume=>Physospermum cornubiense
Ziestblättrige Teufelskralle=>Physostegia virginiana
Halbkugelige Teufelskralle=>Phyteuma betonicifolium
Schwarze Teufelskralle=>Phyteuma hemisphaericum
Kugelige Teufelskralle=>Phyteuma nigrum
Eirunde Teufelskralle=>Phyteuma orbiculare
Ähren-Teufelskralle=>Phyteuma ovatum
Amerikanische Kermesbeere=>Phyteuma spicatum
Asiatische Kermesbeere=>Phytolacca americana
Weiß-Fichte=>Phytolacca esculenta
Stech-Fichte=>Picea glauca
Natternkopf-Bitterkraut=>Picea pungens
Gewöhnliches Bitterkraut=>Picris echioides
Kanonierblume=>Picris hieracioides
Gewöhnlicher Pillenfarn=>Pilea microphylla
Anis=>Pilularia globulifera
Große Bibernelle=>Pimpinella anisum
Fremde Bibernelle=>Pimpinella major
Schwarze Bibernelle=>Pimpinella peregrina
Kleine Bibernelle=>Pimpinella nigra
Dreizählige Pinellie=>Pimpinella saxifraga
Alpen-Fettkraut=>Pinellia ternata
Gewöhnliches Fettkraut=>Pinguicula alpina
Banks-Kiefer=>Pinguicula vulgaris
Arve, Zirbel-Kiefer=>Pinus banksiana
Latsche, Berg-Kiefer=>Pinus cembra
Pech-Kiefer=>Pinus mugo
Weymouth-Kiefer=>Pinus rigida
Wald-Kiefer=>Pinus strobus
Wassersalat=>Pinus sylvestris
Saat-Erbse=>Pistia stratiotes
Berg-Wegerich=>Pisum sativum
Krähenfuß-Wegerich=>Plantago atrata
Spitz-Wegerich=>Plantago coronopus
Breit-Wegerich=>Plantago lanceolata
Alpen-Wegerich=>Plantago major
Strand-Wegerich=>Plantago alpina
Mittlerer Wegerich=>Plantago maritima
Strauch-Wegerich=>Plantago media
Weiße Waldhyazinthe=>Plantago sempervirens
Berg-Waldhyazinthe=>Platanthera bifolia
Österreichischer Rippensame=>Platanthera chlorantha
Alpen-Rispengras=>Pleurospermum austriacum
Einjähriges Rispengras=>Poa alpina
Läger-Rispengras=>Poa annua
Badener Rispengras=>Poa supina
Knolliges Rispengras=>Poa badensis
Mont-Cenis-Rispengras=>Poa bulbosa
Wald-Rispengras=>Poa cenisia
Zusammengedrücktes Rispengras=>Poa chaixii
Blaues Rispengras=>Poa compressa
Bastard-Rispengras=>Poa glauca
Kleines Rispengras=>Poa hybrida
Hain-Rispengras=>Poa minor
Sumpf-Rispengras=>Poa nemoralis
Schmalblättriges Wiesen-Rispengras=>Poa palustris
Bläuliches Wiesen-Rispengras=>Poa angustifolia
Gewöhnliches Wiesen-Rispengras=>Poa humilis
Lockerblütiges Rispengras=>Poa pratensis
Gewöhnliches Rispengras=>Poa remota
Klammkraut=>Poa trivialis
Blaue Himmelsleiter=>Polanisia graveolens
Vierblättriges Nagelkraut=>Polemonium caeruleum
Acker-Knorpelkraut=>Polycarpon tetraphyllum
Warziges Knorpelkraut=>Polycnemum arvense
Großes Knorpelkraut=>Polycnemum verrucosum
Voralpen-Kreuzblümchen=>Polycnemum majus
Bitteres Kreuzblümchen=>Polygala alpestris
Sumpf-Kreuzblümchen=>Polygala amara
Buchsblättriges Kreuzblümchen=>Polygala amarella
Schopfiges Kreuzblümchen=>Polygala chamaebuxus
Quendelblättriges Kreuzblümchen=>Polygala comosa
Gewöhnliches Kreuzblümchen=>Polygala serpyllifolia
Vielblütige Weißwurz=>Polygala vulgaris
Wohlriechende Weißwurz=>Polygonatum multiflorum
Quirlblättrige Weißwurz=>Polygonatum odoratum
Trittrasen-Knöterich=>Polygonatum verticillatum
Vogel-Knöterich=>Polygonum arenastrum
Gesägter Tüpfelfarn=>Polygonum aviculare
Gewöhnlicher Tüpfelfarn=>Polypodium interjectum
Strand-Bürstengras=>Polypodium vulgare
Einjähriges Bürstengras=>Polypogon maritimus
Unbegranntes Bürstengras=>Polypogon monspeliensis
Gelappter Schildfarn=>Polypogon viridis
Brauns Schildfarn=>Polystichum aculeatum
Lanzen-Schildfarn=>Polystichum braunii
Borstiger Schildfarn=>Polystichum lonchitis
Hechtkraut=>Polystichum setiferum
Silber-Pappel=>Pontederia cordata
Balsampappel=>Populus alba
Bastard-Pappel=>Populus balsamifera
Grau-Pappel=>Populus x  canadensis
Schwarz-Pappel=>Populus x  canescens
Birken-Pappel=>Populus nigra
Zitter-Pappel=>Populus simonii
Haarfrüchtige Balsam-Pappel=>Populus tremula
Portulakröschen=>Populus trichocarpa
Portulak=>Portulaca grandiflora
Spitzblättriges Laichkraut=>Portulaca oleracea
Alpen-Laichkraut=>Potamogeton acutifolius
Gefärbtes Laichkraut=>Potamogeton alpinus
Flachstängeliges Laichkraut=>Potamogeton coloratus
Krauses Laichkraut=>Potamogeton compressus
Faden-Laichkraut=>Potamogeton crispus
Stachelspitziges Laichkraut=>Potamogeton filiformis
Grasartiges Laichkraut=>Potamogeton friesii
Glänzendes Laichkraut=>Potamogeton gramineus
Schwimmendes Laichkraut=>Potamogeton lucens
Flutendes Laichkraut=>Potamogeton natans
Stumpfblättriges Laichkraut=>Potamogeton nodosus
Kamm-Laichkraut=>Potamogeton obtusifolius
Durchwachsenes Laichkraut=>Potamogeton pectinatus
Knöterich-Laichkraut=>Potamogeton perfoliatus
Langblättriges Laichkraut=>Potamogeton polygonifolius
Berchtolds Laichkraut=>Potamogeton praelongus
Zwerg-Laichkraut=>Potamogeton berchtoldii
Rötliches Laichkraut=>Potamogeton pusillus
Haarförmiges Laichkraut=>Potamogeton rutilus
Weißes Fingerkraut=>Potamogeton trichoides
Niederliegendes Fingerkraut=>Potentilla alba
Gänse-Fingerkraut=>Potentilla anglica
Silber-Fingerkraut=>Potentilla anserina
Übersehenes Fingerkraut=>Potentilla argentea
Gold-Fingerkraut=>Potentilla neglecta
Zwerg-Fingerkraut=>Potentilla aurea
Stängel-Fingerkraut=>Potentilla brauneana
Tauern-Fingerkraut=>Potentilla caulescens
Hügel-Fingerkraut=>Potentilla clusiana
Weißenburger Fingerkraut=>Potentilla collina
Reichblütiges Hügel-Fingerkraut=>Potentilla leucopolitana
Zottiges Fingerkraut=>Potentilla thyrsiflora
Blutwurz, Blutstillendes Fingerkraut=>Potentilla crantzii
Fingerstrauch=>Potentilla erecta
Großblütiges Fingerkraut=>Potentilla fruticosa
Rötliches Fingerkraut=>Potentilla grandiflora
Sand-Fingerkraut=>Potentilla heptaphylla
Graues Fingerkraut=>Potentilla incana
Mittleres Fingerkraut=>Potentilla inclinata
Kleinblütiges Fingerkraut=>Potentilla intermedia
Norwegisches Fingerkraut=>Potentilla micrantha
Sumpfblutauge, Sumpf-Fingerkraut=>Potentilla norvegica
Hohes Fingerkraut=>Potentilla palustris
Kriechendes Fingerkraut=>Potentilla recta
Felsen-Fingerkraut=>Potentilla reptans
Erdbeer-Fingerkraut=>Potentilla rupestris
Niedriges Fingerkraut=>Potentilla sterilis
Kleinblütiges Fingerkraut=>Potentilla supina
Sternhaariges Frühlings-Fingerkraut=>Potentilla thuringiaca
Gewöhnliches Frühlings-Fingerkraut=>Potentilla pusilla
Purpur-Hasenlattich=>Potentilla tabernaemontani
Aurikel, Öhrchen-Schlüsselblume=>Prenanthes purpurea
Clusius' Schlüsselblume=>Primula auricula
Mehlige Schlüsselblume=>Primula clusiana
Zwerg-Schlüsselblume=>Primula farinosa
Wiesen-Schlüsselblume=>Primula minima
Stängellose Schlüsselblume=>Primula veris
Alpen-Gemskresse=>Primula vulgaris
Großblütige Braunelle=>Pritzelago alpina
Weiße Braunelle=>Prunella grandiflora
Kleine Braunelle=>Prunella laciniata
Vogel-Kirsche=>Prunella vulgaris
Kirschpflaume=>Prunus avium
Sauer-Kirsche=>Prunus cerasifera
Pflaume=>Prunus cerasus
Zwerg-Kirsche=>Prunus domestica
Lorbeerkirsche=>Prunus fruticosa
Stein-Weichsel=>Prunus laurocerasus
Trauben-Kirsche=>Prunus mahaleb
Pfirsich=>Prunus padus
Späte Trauben-Kirsche=>Prunus persica
Gewöhnliche Schlehe=>Prunus serotina
Zwerg-Mandel=>Prunus spinosa
Blassgelber Lerchensporn=>Prunus tenella
Gelber Lerchensporn=>Pseudofumaria alba
Gelbweißes Scheinruhrkraut=>Pseudofumaria lutea
Langblättriger Blauweiderich=>Pseudognaphalium luteoalbum
Ähriger Blauweiderich=>Pseudolysimachion longifolium
Weißzüngel, Weißliche Höswurz=>Pseudolysimachion spicatum
Gewöhnliche Douglasie=>Leucorchis albida
Sand-Wegerich=>Pseudotsuga menziesii
Kleeulme=>Psyllium arenarium
Gewöhnlicher Salzschwaden=>Ptelea trifoliata
Ruhr-Flohkraut=>Puccinellia distans
Kleines Flohkraut=>Pulicaria dysenterica
Schmalblättriges Lungenkraut=>Pulicaria vulgaris
Hügel-Lungenkraut=>Pulmonaria angustifolia
Weiches Lungenkraut=>Pulmonaria collina
Dunkles Lungenkraut=>Pulmonaria mollis
Echtes Lungenkraut=>Pulmonaria obscura
Ziegelrotes Lungenkraut=>Pulmonaria officinalis
Geflecktes Lungenkraut=>Pulmonaria rubra
Alpen-Küchenschelle=>Pulmonaria saccharata
Finger-Küchenschelle=>Pulsatilla alpina
Frühlings-Küchenschelle=>Pulsatilla patens
Gewöhnliche Küchenschelle=>Pulsatilla vernalis
Kegelblume=>Pulsatilla vulgaris
Scharlachroter Feuerdorn=>Puschkinia scilloides
Grünliches Wintergrün=>Pyracantha coccinea
Mittleres Wintergrün=>Pyrola chlorantha
Kleines Wintergrün=>Pyrola media
Rundblättriges Wintergrün=>Pyrola minor
Kultur-Birne=>Pyrola rotundifolia
Wild-Birne=>Pyrus communis
Zerr-Eiche=>Pyrus pyraster
Trauben-Eiche=>Quercus cerris
Stiel-Eiche=>Quercus petraea
Rot-Eiche=>Quercus robur
Zwerg-Lein=>Quercus rubra
Eisenhutblättriger Hahnenfuß=>Radiola linoides
Scharfer Hahnenfuß=>Ranunculus aconitifolius
Alpen-Hahnenfuß=>Ranunculus acris
Gewöhnlicher Wasser-Hahnenfuß=>Ranunculus alpestris
Schild-Wasser-Hahnenfuß=>Ranunculus aquatilis
Pinselblättriger Wasser-Hahnenfuß=>Ranunculus peltatus
Rions Wasserhahnenfuß=>Ranunculus penicillatus
Haarblättriger Wasser-Hahnenfuß=>Ranunculus rionii
Acker-Hahnenfuß=>Ranunculus trichophyllus
Sonderbarer Gold-Hahnenfuß=>Ranunculus arvensis
Erlenwald-Gold-Hahnenfuß=>Ranunculus abstrusus
Elsässischer Gold-Hahnenfuß=>Ranunculus alnetorum
Pontischer Gold-Hahnenfuß=>Ranunculus alsaticus
Aargauer Gold-Hahnenfuß=>Ranunculus ambranus
Abgestutzter Gold-Hahnenfuß=>Ranunculus argoviensis
Bayers Gold-Hahnenfuß=>Ranunculus basitruncatus
Zweigestaltiger Gold-Hahnenfuß=>Ranunculus bayerae
Gestielter Gold-Hahnenfuß=>Ranunculus biformis
Schein-Wenden-Gold-Hahnenfuß=>Ranunculus borchers-kolbiae
Gleichblättriger Gold-Hahnenfuß=>Ranunculus cassubicifolius
Fingerblättriger Gold-Hahnenfuß=>Ranunculus constans
Donau-Gold-Hahnenfuß=>Ranunculus dactylophyllus
Dörrs Gold-Hahnenfuß=>Ranunculus danubius
Haasscher Gold-Hahnenfuß=>Ranunculus doerrii
Rathenower Gold-Hahnenfuß=>Ranunculus haasii
Blütenblattarmer Gold-Hahnenfuß=>Ranunculus hevellus
Ganzrandiger Gold-Hahnenfuß=>Ranunculus indecorus
Kunze-Gold-Hahnenfuß=>Ranunculus integerrimus
Feinstängeliger Gold-Hahnenfuß=>Ranunculus kunzii
Hain-Gold-Hahnenfuß=>Ranunculus leptomeris
Großfrüchtiger Gold-Hahnenfuß=>Ranunculus lucorum
Mergenthalers Gold-Hahnenfuß=>Ranunculus megacarpus
Münchener Gold-Hahnenfuß=>Ranunculus mergenthaleri
Vielteiliger Gold-Hahnenfuß=>Ranunculus monacensis
Nickles' Gold-Hahnenfuß=>Ranunculus multisectus
Stattlicher Gold-Hahnenfuß=>Ranunculus nicklesi
Röhricht-Gold-Hahnenfuß=>Ranunculus opimus
Unechter Stattlicher Gold-Hahnenfuß=>Ranunculus phragmiteti
Unechter Veränderlicher Gold-Hahnenfuß=>Ranunculus pseudopimus
Behaarter Gold-Hahnenfuß=>Ranunculus pseudovertumnalis
Gerader Gold-Hahnenfuß=>Ranunculus puberulus
Rhombusblättriger Gold-Hahnenfuß=>Ranunculus recticaulis
Rösslers Gold-Hahnenfuß=>Ranunculus rhombilobus
Geschnäbelter Gold-Hahnenfuß=>Ranunculus roessleri
Rundlicher Gold-Hahnenfuß=>Ranunculus rostratulus
Aufrechter Gold-Hahnenfuß=>Ranunculus rotundatus
Runder Gold-Hahnenfuß=>Ranunculus stricticaulis
Schwäbischer Gold-Hahnenfuß=>Ranunculus suborbicularis
Wechselnder Gold-Hahnenfuß=>Ranunculus suevicus
Vielgestaltiger Gold-Hahnenfuß=>Ranunculus transiens
Veränderlicher Gold-Hahnenfuß=>Ranunculus variabilis
Kochs Gold-Hahnenfuß=>Ranunculus vertumnalis
Knolliger Hahnenfuß=>Ranunculus walo-kochii
Spreizender Wasser-Hahnenfuß=>Ranunculus bulbosus
Scharbockskraut=>Ranunculus circinatus
Brennender Hahnenfuß=>Ranunculus ficaria
Ufer-Hahnenfuß=>Ranunculus flammula
Flutender Wasser-Hahnenfuß=>Ranunculus reptans
Gletscher-Hahnenfuß=>Ranunculus fluitans
Bastard-Hahnenfuß=>Ranunculus glacialis
Wolliger Hahnenfuß=>Ranunculus hybridus
Zungen-Hahnenfuß=>Ranunculus lanuginosus
Vorland-Berg-Hahnenfuß=>Ranunculus lingua
Gewöhnlicher Berg-Hahnenfuß=>Ranunculus breyninus
Greniers Berg-Hahnenfuß=>Ranunculus montanus
Herzblättriger Hahnenfuß=>Ranunculus villarsii
Platanenblättriger Hahnenfuß=>Ranunculus parnassiifolius
Gewöhnlicher Hain-Hahnenfuß=>Ranunculus platanifolius
Polyanthemusähnlicher Hain-Hahnenfuß=>Ranunculus nemorosus
Schlitzblättriger Hain-Hahnenfuß=>Ranunculus polyanthemoides
Vielblütiger Hain-Hahnenfuß=>Ranunculus polyanthemophyllus
Wurzelnder Hain-Hahnenfuß=>Ranunculus polyanthemos
Kriechender Hahnenfuß=>Ranunculus serpens
Sardischer Hahnenfuß=>Ranunculus repens
Gift-Hahnenfuß=>Ranunculus sardous
Acker-Hederich=>Ranunculus sceleratus
Garten-Rettich=>Raphanus raphanistrum
Ausdauernder Rapsdotter=>Raphanus sativus
Runzeliger Rapsdotter=>Rapistrum perenne
Bitterkraut-Reichardie=>Rapistrum rugosum
Weiße Resede=>Reichardia picroides
Gelber Wau=>Reseda alba
Färber-Wau=>Reseda lutea
Gartenresede=>Reseda luteola
Purgier-Kreuzdorn=>Reseda odorata
Zwerg-Kreuzdorn=>Rhamnus cathartica
Felsen-Kreuzdorn=>Rhamnus pumila
Rhabarber=>Rhamnus saxatilis
Zottiger Klappertopf=>Rheum rhabarbarum
Großer Klappertopf=>Rhinanthus alectorolophus
Grannen-Klappertopf=>Rhinanthus angustifolius
Kleiner Klappertopf=>Rhinanthus glacialis
Gewöhnliche Rosenwurz=>Rhinanthus minor
Rostblättrige Alpenrose=>Rhodiola rosea
Bewimperte Alpenrose=>Rhododendron ferrugineum
Pontische Alpenrose=>Rhododendron hirsutum
Ostalpen-Zwergalpenrose=>Rhododendron luteum
Gerber-Sumach=>Rhodothamnus chamaecistus
Essigbaum=>Rhus coriaria
Weißes Schnabelried=>Rhus hirta
Braunes Schnabelried=>Rhynchospora alba
Alpen-Johannisbeere=>Rhynchospora fusca
Gold-Johannisbeere=>Ribes alpinum
Schwarze Johannisbeere=>Ribes aureum
Wohlriechende Johannisbeere=>Ribes nigrum
Felsen-Johannisbeere=>Ribes odoratum
Rote Johannisbeere=>Ribes petraeum
Ährige Johannisbeere=>Ribes rubrum
Blutjohannisbeere=>Ribes spicatum
Stachelbeere=>Ribes sanguineum
Wunderbaum=>Ribes uva-crispa
Gewöhnliche Robinie=>Ricinus communis
Wasser-Sumpfkresse=>Robinia pseudoacacia
Niederliegende Sumpfkresse=>Rorippa amphibia
Österreichische Sumpfkresse=>Rorippa anceps
Island-Sumpfkresse=>Rorippa austriaca
Gewöhnliche Sumpfkresse=>Rorippa islandica
Wilde Sumpfkresse=>Rorippa palustris
Feld-Rose=>Rorippa sylvestris
Kriechende Rose=>Rosa agrestis
Lederblättrige Rose=>Rosa arvensis
Falsche Hecken-Rose=>Rosa caesia
Hunds-Rose=>Rosa subcollina
Hecken-Rose=>Rosa canina
Vogesen-Rose=>Rosa corymbifera
Falsche Hunds-Rose=>Rosa dumalis
Keilblättrige Rose=>Rosa subcanina
Wildrose=>Rosa elliptica
Essig-Rose=>Rosa foetida
Rotblättrige Rose=>Rosa gallica
Duftarme Rose=>Rosa glauca
Rauhblättrige Rose=>Rosa inodora
Zimt-Rose=>Rosa jundzillii
Kleinblütige Rose=>Rosa majalis
Büschelrose=>Rosa micrantha
Alpen-Rose=>Rosa multiflora
Wein-Rose=>Rosa pendulina
Kartoffel-Rose=>Rosa rubiginosa
Bibernell-Rose=>Rosa rugosa
Tannen-Rose=>Rosa spinosissima
Flaum-Rose=>Rosa abietina
Weiche Rose=>Rosa tomentella
Falsche Filz-Rose=>Rosa mollis
Samt-Rose=>Rosa pseudoscabriuscula
Filz-Rose=>Rosa sherardii
Apfel-Rose=>Rosa tomentosa
Echtes Büschelgras=>Rosa villosa
Färberkrapp=>Rostraria cristata
Zimt-Himbeere=>Rubia tinctorum
Steinbeere=>Rubus odoratus
Himbeere=>Rubus saxatilis
Japanische Weinbeere=>Rubus idaeus
Pracht-Himbeere=>Rubus phoenicolasius
Kratzbeere=>Rubus spectabilis
Drüsenborstige Haselblatt-Brombeere=>Rubus caesius
Fürnrohrs Haselblatt-Brombeere=>Rubus dollnensis
Nordschweizer Haselblatt-Brombeere=>Rubus fuernrohrii
Sendtners Haselblatt-Brombeere=>Rubus pseudopsis
Waldbewohnende Haselblatt-Brombeere=>Rubus sendtneri
Schweizer Haselblatt-Brombeere=>Rubus sylvulicola
Krummnadelige Haselblatt-Brombeere=>Rubus villarsianus
Fränkische Haselblatt-Brombeere=>Rubus curvaciculatus
Dickstachelige Haselblatt-Brombeere=>Rubus franconicus
Geradachsenförmige Haselblatt-Brombeere=>Rubus hadracanthos
Wessbergs Haselblatt-Brombeere=>Rubus orthostachyoides
Samtblättrige Haselblatt-Brombeere=>Rubus wessbergii
Bayreuther Haselblatt-Brombeere=>Rubus amphimalacus
Falsche Büschelblütige Haselblatt-Brombeere=>Rubus baruthicus
Büschelblütige Haselblatt-Brombeere=>Rubus fasciculatiformis
Weißgraue Haselblatt-Brombeere=>Rubus fasciculatus
Weiche Haselblatt-Brombeere=>Rubus leucophaeus
Rhombische Haselblatt-Brombeere=>Rubus mollis
Weser-Haselblatt-Brombeere=>Rubus rhombicus
Schwäbische Haselblatt-Brombeere=>Rubus visurgianus
Holubs Haselblatt-Brombeere=>Rubus suevicola
Feingesägte Haselblatt-Brombeere=>Rubus josefianus
Lappenzähnige Haselblatt-Brombeere=>Rubus lamprocaulos
Geradachsige Haselblatt-Brombeere=>Rubus lobatidens
Zugespitzte Haselblatt-Brombeere=>Rubus orthostachys
Schmiedeberger Haselblatt-Brombeere=>Rubus cuspidatus
Schreckliche Haselblatt-Brombeere=>Rubus fabrimontanus
Limes-Haselblatt-Brombeere=>Rubus horridus
Höckerige Haselblatt-Brombeere=>Rubus limitis
Bewimperte Haselblatt-Brombeere=>Rubus tuberculatus
Hain-Haselblatt-Brombeere=>Rubus camptostachys
Friedliche Haselblatt-Brombeere=>Rubus nemorosus
Gotische Haselblatt-Brombeere=>Rubus placidus
Grobe Haselblatt-Brombeere=>Rubus gothicus
Kuleschas Haselblatt-Brombeere=>Rubus grossus
Stohrs Haselblatt-Brombeere=>Rubus kuleszae
Wahlbergs Haselblatt-Brombeere=>Rubus stohrii
Bereifte Haselblatt-Brombeere=>Rubus wahlbergii
Falsche Feindliche Brombeere=>Rubus pruinosus
Filz-Brombeere=>Rubus pseudinfestus
Weißblütige Brombeere=>Rubus canescens
Asbestschimmernde Brombeere=>Rubus albiflorus
Ardennen-Brombeere=>Rubus amiantinus
Armenische Brombeere=>Rubus arduennensis
Zweifarbige Brombeere=>Rubus armeniacus
Höhere Brombeere=>Rubus bifrons
Gekniete Brombeere=>Rubus elatior
Winkel-Brombeere=>Rubus geniculatus
Grabowskis Brombeere=>Rubus goniophorus
Hessische Brombeere=>Rubus grabowskii
Östliche Brombeere=>Rubus hassicus
Mittelgebirgs-Brombeere=>Rubus henrici-egonis
Jungfernreben-Brombeere=>Rubus montanus
Wellige Brombeere=>Rubus parthenocissus
Lügen-Brombeere=>Rubus pericrispatus
Durchblätterte Brombeere=>Rubus perperus
Robuste Brombeere=>Rubus phyllostachys
Mittelmeer-Brombeere=>Rubus praecox
Vielschwänzige Brombeere=>Rubus ulmifolius
Entwaffnete Brombeere=>Rubus elegans
Günthers Brombeere=>Rubus exarmatus
Harzer Brombeere=>Rubus guentheri
Dunkeldrüsige Brombeeren=>Rubus hercynicus
Jansens Brombeere=>Rubus hirtus
Bleigraue Brombeere=>Rubus jansenii
Bergnymphen-Brombeere=>Rubus lividus
Träufelspitzen-Brombeere=>Rubus oreades
Verlängerte Brombeere=>Rubus pedemontanus
Besonnte Brombeere=>Rubus perlongus
Bayerische Brombeere=>Rubus apricus
Dickblättrige Brombeere=>Rubus bavaricus
Köhlers Brombeere=>Rubus dasyphyllus
Meierotts Brombeere=>Rubus koehleri
Schleichers Brombeere=>Rubus meierottii
Hofmanns Brombeere=>Rubus schleicheri
Schwankende Brombeere=>Rubus acanthodes
Caflischs Brombeere=>Rubus amphistrophos
Freudiggrüne Brombeere=>Rubus caflischii
Clusius' Brombeere=>Rubus chaerophyllus
Gedrängtblütige Brombeere=>Rubus clusii
Zwillings-Brombeere=>Rubus condensatus
Raspelartige Brombeere=>Rubus geminatus
Zarte Brombeere=>Rubus raduloides
Samtblättrige Brombeere=>Rubus thelybatos
Pickelhauben-Brombeere=>Rubus hypomalacus
Bregenzer Brombeere=>Rubus mucronulatus
Hunsrück-Brombeere=>Rubus bregutiensis
Blattreiche Brombeere=>Rubus caninitergi
Löhrs Brombeere=>Rubus foliosus
Inn-Brombeere=>Rubus loehrii
Bleiche Brombeere=>Rubus oenensis
Schnedlers Brombeere=>Rubus pallidus
Herzähnliche Brombeere=>Rubus schnedleri
Rundstängelige Brombeere=>Rubus subcordatus
Falsche Samtbrombeere=>Rubus tereticaulis
Dörrs Brombeere=>Rubus transvestitus
Kahlstirnige Brombeere=>Rubus doerrii
Chiemgauer Brombeere=>Rubus epipsilos
Gegengewundene Brombeere=>Rubus indusiatus
Breitköpfige Brombeere=>Rubus muhelicus
Ausgemessene Brombeere=>Rubus platycephalus
Raspel-Brombeere=>Rubus perpedatus
Rauhe Brombeere=>Rubus radula
Salzburger Brombeere=>Rubus rudis
Felsenbewohnende Brombeere=>Rubus salisburgensis
Thüringer Brombeere=>Rubus saxicola
Haarstängelige Brombeere=>Rubus thuringensis
Schlitzblättrige Brombeere=>Rubus gracilis
Langes Brombeere=>Rubus laciniatus
Hain-Brombeere=>Rubus langei
Gewöhnliche Brombeere=>Rubus nemoralis
Hainbuchenblättrige Brombeere=>Rubus vulgaris
Wandernde Brombeere=>Rubus adspersus
Circipanier-Brombeere=>Rubus ambulans
Angenehme Brombeere=>Rubus circipanicus
Großblättrige Brombeere=>Rubus gratus
Neumanns Brombeere=>Rubus macrophyllus
Stumpfkantige Brombeere=>Rubus neumannianus
Schattenliebende Brombeere=>Rubus obtusangulus
Wald-Brombeere=>Rubus sciocharis
Arrhenius' Brombeere=>Rubus silvaticus
Braeuckers Brombeere=>Rubus arrhenii
Sprengels Brombeere=>Rubus braeuckeri
Ansehnliche Brombeere=>Rubus sprengelii
Eifel-Brombeere=>Rubus conspicuus
Pyramiden-Brombeere=>Rubus eifeliensis
Samt-Brombeere=>Rubus pyramidalis
Allegheny-Brombeere=>Rubus vestitus
Kanadische Brombeere=>Rubus allegheniensis
Halbaufrechte Brombeere=>Rubus canadensis
Eingeschnittene Brombeere=>Rubus nessensis
Barrandische Brombeere=>Rubus scissus
Bertrams Brombeere=>Rubus barrandienicus
Zusammengezogene Brombeere=>Rubus bertramii
Dunkle Brombeere=>Rubus constrictus
Grobe Brombeere=>Rubus opacus
Falten-Brombeere=>Rubus perrobustus
Dornige Brombeere=>Rubus plicatus
Gefurchte Brombeere=>Rubus senticosus
Üppige Brombeere=>Rubus sulcatus
Gewöhnlicher Sonnenhut=>Rubus vigorosus
Rauher Sonnenhut=>Rudbeckia fulgida
Schlitzblättriger Sonnenhut=>Rudbeckia hirta
Großer Sauer-Ampfer=>Rudbeckia laciniata
Kleiner Sauer-Ampfer=>Rumex acetosa
Wasser-Ampfer=>Rumex acetosella
Berg-Sauer-Ampfer=>Rumex aquaticus
Knäuelblütiger Ampfer=>Rumex arifolius
Krauser Ampfer=>Rumex conglomeratus
Griechischer Ampfer=>Rumex crispus
Fluss-Ampfer=>Rumex cristatus
Gemüse-Ampfer=>Rumex hydrolapathum
Ufer-Ampfer=>Rumex longifolius
Schnee-Ampfer=>Rumex maritimus
Stumpfblättriger Ampfer=>Rumex nivalis
Sumpf-Ampfer=>Rumex obtusifolius
Garten-Ampfer=>Rumex palustris
Alpen-Ampfer=>Rumex patientia
Schöner Ampfer=>Rumex pseudoalpinus
Hain-Ampfer=>Rumex pulcher
Schild-Ampfer=>Rumex sanguineus
Schmalblättriger Ampfer=>Rumex scutatus
Straußblütiger Sauer-Ampfer=>Rumex stenophyllus
Mäusedorn=>Rumex thyrsiflorus
Weinraute=>Ruscus aculeatus
Kronblattloses Mastkraut=>Ruta graveolens
Aufrechtes Mastkraut=>Sagina apetala
Knotiges Mastkraut=>Sagina micropetala
Niederliegendes Mastkraut=>Sagina nodosa
Alpen-Mastkraut=>Sagina procumbens
Pfriemen-Mastkraut=>Sagina saginoides
Breitblättriges Pfeilkraut=>Sagina subulata
Gewöhnliches Pfeilkraut=>Sagittaria latifolia
Kurzähren-Queller=>Sagittaria sagittifolia
Spitzblättrige Weide=>Salicornia europaea
Silber-Weide=>Salix acutifolia
Alpen-Weide=>Salix alba
Großblättrige Weide=>Salix alpina
Ohr-Weide=>Salix appendiculata
Matten-Weide=>Salix aurita
Blau-Weide=>Salix breviserrata
Sal-Weide=>Salix caesia
Grau-Weide=>Salix caprea
Reif-Weide=>Salix cinerea
Filzast-Weide=>Salix daphnoides
Lavendel-Weide=>Salix dasyclados
Herzblatt-Weide=>Salix eleagnos
Bruch-Weide=>Salix eriocephala
Kahle Weide=>Salix fragilis
Spieß-Weide=>Salix glabra
Kraut-Weide=>Salix hastata
Schwarzwerdende Weide=>Salix herbacea
Heidelbeer-Weide=>Salix myrsinifolia
Lorbeer-Weide=>Salix myrtilloides
Purpur-Weide=>Salix pentandra
Balsam-Weide=>Salix purpurea
Kriech-Weide=>Salix pyrifolia
Rosmarin-Weide=>Salix repens
Netz-Weide=>Salix rosmarinifolia
Stumpfblättrige Teppich-Weide=>Salix reticulata
Quendelblättrige Teppich-Weide=>Salix retusa
Bleiche Weide=>Salix serpillifolia
Mandel-Weide=>Salix starkeana
Korb-Weide=>Salix triandra
Bäumchen-Weide=>Salix viminalis
Trompetenzunge=>Salix waldsteiniana
Kali-Salzkraut=>Salpiglossis sinuata
Mohren-Salbei=>Salsola kali
Klebriger Salbei=>Salvia aethiopis
Hain-Salbei=>Salvia glutinosa
Echter Salbei=>Salvia nemorosa
Wiesen-Salbei=>Salvia officinalis
Zurückgebogener Salbei=>Salvia pratensis
Muskatellersalbei=>Salvia reflexa
Quirlblütiger Salbei=>Salvia sclarea
Ruten-Salbei=>Salvia verticillata
Grüner Salbei=>Salvia virgata
Gewöhnlicher Schwimmfarn=>Salvia viridis
Zwerg-Holunder=>Salvinia natans
Schwarzer Holunder=>Sambucus ebulus
Trauben-Holunder=>Sambucus nigra
Salz-Bunge=>Sambucus racemosa
Kleiner Wiesenknopf=>Samolus valerandi
Großer Wiesenknopf=>Sanguisorba minor
Wald-Sanikel=>Sanguisorba officinalis
Zypressenkraut=>Sanicula europaea
Husarenknöpfchen=>Santolina chamaecyparissus
Kalabrisches Seifenkraut=>Sanvitalia procumbens
Kleines Seifenkraut=>Saponaria calabrica
Gewöhnliches Seifenkraut=>Saponaria ocymoides
Braunrote Schlauchpflanze=>Saponaria officinalis
Sommer-Bohnenkraut=>Sarracenia purpurea
Winter-Bohnenkraut=>Satureja hortensis
Gewöhnliche Alpenscharte=>Satureja montana
Zweifarbige Alpenscharte=>Saussurea alpina
Zwerg-Alpenscharte=>Saussurea discolor
Fetthennen-Steinbrech=>Saussurea pygmaea
Mannsschild-Steinbrech=>Saxifraga aizoides
Blattloser Steinbrech=>Saxifraga androsacea
Moos-Steinbrech=>Saxifraga aphylla
Bursers Steinbrech=>Saxifraga bryoides
Blaugrüner Steinbrech=>Saxifraga burseriana
Rasen-Steinbrech=>Saxifraga caesia
Strauß-Steinbrech=>Saxifraga cespitosa
Knöllchen-Steinbrech=>Saxifraga cotyledon
Moor-Steinbrech=>Saxifraga granulata
Südalpen-Steinbrech=>Saxifraga hirculus
Moossteinbrech=>Saxifraga hostii
Moschus-Steinbrech=>Saxifraga hypnoides
Kies-Steinbrech=>Saxifraga moschata
Gegenblättriger Steinbrech=>Saxifraga mutata
Trauben-Steinbrech=>Saxifraga oppositifolia
Rasen-Steinbrech=>Saxifraga paniculata
Fettkraut-Steinbrech=>Saxifraga rosacea
Stern-Steinbrech=>Saxifraga sedoides
Dreifinger-Steinbrech=>Saxifraga stellaris
Behaarter Steinbrech=>Saxifraga tridactylites
Schatten-Steinbrech=>Saxifraga hirsuta
Graue Skabiose=>Saxifraga umbrosa
Tauben-Skabiose=>Scabiosa canescens
Glänzende Skabiose=>Scabiosa columbaria
Gelbe Skabiose=>Scabiosa lucida
Südliche Skabiose=>Scabiosa ochroleuca
Iberischer Venuskamm=>Scabiosa triandra
Venuskamm-Nadelkerbel=>Scandix iberica
Sumpf-Blumenbinse=>Scandix pecten-veneris
Gewöhnliche Teichsimse=>Scheuchzeria palustris
Salz-Teichsimse=>Schoenoplectus lacustris
Stachelspitzige Teichsimse=>Schoenoplectus tabernaemontani
Niedrige Teichsimse=>Schoenoplectus mucronatus
Dreikantige Teichsimse=>Schoenoplectus supinus
Rostrotes Kopfried=>Schoenoplectus triqueter
Schwarzes Kopfried=>Schoenus ferrugineus
Schöner Blaustern=>Schoenus nigricans
Zweiblättriger Blaustern=>Scilla amoena
Mischtschenko-Blaustern=>Scilla bifolia
Sibirischer Blaustern=>Scilla mischtschenkoana
Wurzelnde Simse=>Scilla siberica
Wald-Simse=>Scirpus radicans
Einjähriger Knäuel=>Scirpus sylvaticus
Triften-Knäuel=>Scleranthus annuus
Ausdauernder Knäuel=>Scleranthus polycarpos
Gewöhnliches Hartgras=>Scleranthus perennis
Jacquin-Schwarzwurzel=>Sclerochloa dura
Garten-Schwarzwurzel=>Scorzonera cana
Niedrige Schwarzwurzel=>Scorzonera hispanica
Schlitzblättrige Schwarzwurzel=>Scorzonera humilis
Violette Schwarzwurzel=>Scorzonera laciniata
Knotige Braunwurz=>Scorzonera purpurea
Drüsige Braunwurz=>Scrophularia nodosa
Flügel-Braunwurz=>Scrophularia scopolii
Frühlings-Braunwurz=>Scrophularia umbrosa
Hohes Helmkraut=>Scrophularia vernalis
Sumpf-Helmkraut=>Scutellaria altissima
Spießblättriges Helmkraut=>Scutellaria galericulata
Kleines Helmkraut=>Scutellaria hastifolia
Roggen=>Scutellaria minor
Bunte Kronwicke=>Secale cereale
Scharfer Mauerpfeffer=>Securigera varia
Weiße Fetthenne=>Sedum acre
Alpen-Fetthenne=>Sedum album
Einjährige Fetthenne=>Sedum alpestre
Schwärzliche Fetthenne=>Sedum annuum
Zwiebel-Fetthenne=>Sedum atratum
Dickblättrige Fetthenne=>Sedum cepaea
Gold-Fetthenne=>Sedum dasyphyllum
Behaarter Mauerpfeffer=>Sedum floriferum
Spanische Fetthenne=>Sedum hirsutum
Immergrüne Mongolen-Fetthenne=>Sedum hispanicum
Kamtschatka-Fetthenne=>Sedum hybridum
Felsen-Fetthenne=>Sedum kamtschaticum
Östlicher Mauerpfeffer=>Sedum rupestre
Ausläufer-Fetthenne=>Sedum thartii
Nizza-Fetthenne=>Sedum sarmentosum
Milder Mauerpfeffer=>Sedum sediforme
Hohe Fetthenne=>Sedum sexangulare
Kaukasus-Fetthenne=>Sedum spectabile
Große Fetthenne=>Sedum spurium
Purpur-Fetthenne=>Sedum maximum
Sumpf-Fetthenne=>Sedum telephium
Schweizer Moosfarn=>Sedum villosum
Gezähnter Moosfarn=>Selaginella helvetica
Kümmel-Silge=>Selaginella selaginoides
Spinnweben-Hauswurz=>Selinum carvifolia
Dach-Hauswurz=>Sempervivum arachnoideum
Eberrauten-Greiskraut=>Sempervivum tectorum
Alpen-Greiskraut=>Senecio abrotanifolius
Wasser-Greiskraut=>Senecio alpinus
Gemswurz-Greiskraut=>Senecio aquaticus
Raukenblättriges Greiskraut=>Senecio doronicum
Schmalblättriges Greiskraut=>Senecio erucifolius
Krainer Greiskraut=>Senecio inaequidens
Jakobs-Greiskraut=>Senecio incanus
Jacquins Hain-Greiskraut=>Senecio jacobaea
Gewöhnliches Hain-Greiskraut=>Senecio germanicus
Hain-Greiskraut=>Senecio hercynicus
Sumpf-Greiskraut=>Senecio ovatus
Felsen-Greiskraut=>Senecio paludosus
Fluss-Greiskraut=>Senecio rupestris
Berg-Greiskraut=>Senecio sarracenicus
Wald-Greiskraut=>Senecio subalpinus
Velenovskys Greiskraut=>Senecio sylvaticus
Frühlings-Greiskraut=>Senecio velenovskyi
Klebriges Greiskraut=>Senecio vernalis
Gewöhnliches Greiskraut=>Senecio viscosus
Färber-Scharte=>Senecio vulgaris
Steppen-Bergfenchel=>Serratula tinctoria
Heilwurz, Weihrauch-Bergfenchel=>Seseli annuum
Berg-Sesel=>Seseli libanotis
Kalk-Blaugras=>Seseli montanum
Eiköpfiges Blaugras=>Sesleria albicans
Fabers Borstenhirse=>Sesleria ovata
Kolbenhirse=>Setaria faberi
Rote Borstenhirse=>Setaria italica
Quirlige Borstenhirse=>Setaria pumila
Grüne Borstenhirse=>Setaria verticillata
Ackerröte=>Setaria viridis
Alpen-Gelbling=>Sherardia arvensis
Riesen-Prunkwinde=>Sibbaldia procumbens
Rautenblättrige Prunkwinde=>Sida hermaphrodita
Efeublättrige Prunkwinde=>Sida rhombifolia
Berg-Gliedkraut=>Sida spinosa
Römisches Gliedkraut=>Sideritis montana
Siegesbeckie=>Sideritis romana
Wiesen-Silge=>Sigesbeckia serrata
Stängellose Lichtnelke=>Silaum silaus
Nelken-Lichtnelke=>Silene acaulis
Gänseblümchenblättrige Lichtnelke=>Silene armeria
Brennende Liebe=>Silene bellidifolia
Kegelfrüchtige Lichtnelke=>Silene chalcedonica
Großkegel-Leimkraut=>Silene conica
Kronen-Lichtnelke=>Silene conoidea
Kreta-Lichtnelke=>Silene coronaria
Gabel-Lichtnelke=>Silene cretica
Rote Lichtnelke=>Silene dichotoma
Kuckucks-Lichtnelke=>Silene dioica
Jupiter-Lichtnelke=>Silene flos-cuculi
Französisches Lichtnelke=>Silene flos-jovis
Italienisches Lichtnelke=>Silene gallica
Hain-Leimkraut=>Silene italica
Weiße Lichtnelke=>Silene nemoralis
Flachs-Lichtnelke=>Silene latifolia
Acker-Lichtnelke=>Silene linicola
Nickende Lichtnelke=>Silene noctiflora
Ohrlöffel-Lichtnelke=>Silene nutans
Hängendes Leimkraut=>Silene otites
Kleine Lichtnelke=>Silene pendula
Felsen-Lichtnelke=>Silene pusilla
Pechnelke, Klebrige Lichtnelke=>Silene rupestris
Taubenkropf-Lichtnelke=>Silene viscaria
Durchwachsende Silphie=>Silene vulgaris
Gewöhnliche Mariendistel=>Silphium perfoliatum
Weißer Senf=>Silybum marianum
Acker-Senf=>Sinapis alba
Ungarische Rauke=>Sinapis arvensis
Österreichische Rauke=>Sisymbrium altissimum
Glanz-Rauke=>Sisymbrium austriacum
Loesels Rauke=>Sisymbrium irio
Weg-Rauke=>Sisymbrium loeselii
Orientalische Rauke=>Sisymbrium officinale
Reichblättrige Rauke=>Sisymbrium orientale
Steife Rauke=>Sisymbrium polyceratium
Wolga-Rauke=>Sisymbrium strictissimum
Schmalblättriges Grasschwertel=>Sisymbrium volgense
Großer Merk=>Sisyrinchium bermudiana
Stengelumfassende Gelbdolde=>Sium latifolium
Stachel-Nachtschatten=>Smyrnium perfoliatum
Bittersüßer Nachtschatten=>Solanum cornutum
Känguruh-Apfel=>Solanum dulcamara
Schwarzer Nachtschatten=>Solanum laciniatum
Argentinischer Nachtschatten=>Solanum nigrum
Kartoffel=>Solanum physalifolium
Gelbfrüchtiger Nachtschatten=>Solanum tuberosum
Zwerg-Alpenglöckchen=>Solanum villosum
Gewöhnliches Alpenglöckchen=>Soldanella alpicola
Österreichisches Alpenglöckchen=>Soldanella alpina
Winziges Alpenglöckchen=>Soldanella austriaca
Berg-Alpenglöckchen=>Soldanella minima
Bubikopf=>Soldanella montana
Kanadische Goldrute=>Soleirolia soleirolii
Späte Goldrute=>Solidago canadensis
Grasblättrige Goldrute=>Solidago gigantea
Gewöhnliche Goldrute=>Solidago graminifolia
Acker-Gänsedistel=>Solidago virgaurea
Rauhe Gänsedistel=>Sonchus arvensis
Kohl-Gänsedistel=>Sonchus asper
Sumpf-Gänsedistel=>Sonchus oleraceus
Fieder-Spierstrauch=>Sonchus palustris
Gewöhnliche Mehlbeere=>Sorbaria sorbifolia
Donau-Mehlbeere=>Sorbus aria
Pannonische Mehlbeere=>Sorbus danubialis
Vogelbeere, Eberesche=>Sorbus pannonica
Zwerg-Mehlbeere=>Sorbus aucuparia
Speierling=>Sorbus chamaemespilus
Dörrs Zwerg-Mehlbeere=>Sorbus domestica
Gaucklers Mehlbeere=>Sorbus doerriana
Harz' Mehlbeere=>Sorbus gauckleri
Hohenesters Mehlbeere=>Sorbus harziana
Echte Bastard-Eberesche=>Sorbus hohenesteri
Vogesen-Mehlbeere=>Sorbus hybrida
Hersbrucker Mehlbeere=>Sorbus mougeotii
Gößweinsteiner Mehlbeere=>Sorbus pseudothuringiaca
Schwarz' Mehlbeere=>Sorbus pulchra
Schwedische Mehlbeere=>Sorbus schwarziana
Ades Mehlbeere=>Sorbus intermedia
Badische Mehlbeere=>Sorbus adeana
Löffelblättrige Mehlbeere=>Sorbus badensis
Kordigast-Mehlbeere=>Sorbus cochleariformis
Eichstätter Mehlbeere=>Sorbus cordigastensis
Ries-Mehlbeere=>Sorbus eystettensis
Fränkische Mehlbeere=>Sorbus fischeri
Thüngersheimer Mehlbeere=>Sorbus franconica
Würzburger Mehlbeere=>Sorbus haesitans
Hoppes Mehlbeere=>Sorbus herbipolitana
Breitblättrige Mehlbeere=>Sorbus hoppeana
Meierotts Mehlbeere=>Sorbus latifolia
Mergenthalers Mehlbeere=>Sorbus meierottii
Langblättrige Mehlbeere=>Sorbus mergenthaleriana
Mädchen-Mehlbeere=>Sorbus perlonga
Regensburger Mehlbeere=>Sorbus puellarum
Schnizleins Mehlbeere=>Sorbus ratisbonensis
Schuwerks Mehlbeere=>Sorbus schnizleiniana
Allgäuer Zwerg-Mehlbeere=>Sorbus schuwerkiorum
Elsbeere=>Sorbus algoviensis
Mohrenhirse=>Sorbus torminalis
Wilde Mohrenhirse=>Sorghum bicolor
Schmalblättriger Igelkolben=>Sorghum halepense
Einfacher Igelkolben=>Sparganium angustifolium
Aufrechter Igelkolben=>Sparganium emersum
Zwerg-Igelkolben=>Sparganium erectum
Goldleistengras=>Sparganium natans
Acker-Spark=>Spartina pectinata
Frühlings-Spark=>Spergula arvensis
Fünfmänniger Spark=>Spergula morisonii
Rote Schuppenmiere=>Spergula pentandra
Salz-Schuppenmiere=>Spergularia rubra
Getreide-Schuppenmiere=>Spergularia salina
Echter Spinat=>Spergularia segetalis
Billards Spierstrauch=>Spinacia oleracea
Gamander-Spierstrauch=>Spiraea billardii
Douglas-Spierstrauch=>Spiraea chamaedryfolia
Japanischer Spierstrauch=>Spiraea douglasii
Karpaten-Spierstrauch=>Spiraea japonica
Weidenblättriger Spierstrauch=>Spiraea media
Frühlingsspiere=>Spiraea salicifolia
Sommer-Wendelähre=>Spiraea thunbergii
Herbst-Wendelähre=>Spiranthes aestivalis
Vielwurzelige Teichlinse=>Spiranthes spiralis
Alpen-Ziest=>Spirodela polyrhiza
Einjähriger Ziest=>Stachys alpina
Acker-Ziest=>Stachys annua
Wollziest=>Stachys arvensis
Deutscher Ziest=>Stachys byzantina
Großblumiger Ziest=>Stachys germanica
Sumpf-Ziest=>Stachys macrantha
Aufrechter Ziest=>Stachys palustris
Wald-Ziest=>Stachys recta
Pimpernuss=>Stachys sylvatica
Bach-Sternmiere=>Staphylea pinnata
Wasserdarm, Wasser-Sternmiere=>Stellaria alsine
Dickblättrige Sternmiere=>Stellaria aquatica
Gras-Sternmiere=>Stellaria crassifolia
Große Sternmiere=>Stellaria graminea
Langblättrige Sternmiere=>Stellaria holostea
Gewöhnliche Vogelmiere=>Stellaria longifolia
Großblütige Vogelmiere=>Stellaria media
Bleiche Vogelmiere=>Stellaria neglecta
Hain-Sternmiere=>Stellaria pallida
Sumpf-Sternmiere=>Stellaria nemorum
Alpen-Rauhgras, Alpen-Federgras=>Stellaria palustris
Haar-Federgras=>Stipa calamagrostis
Zierliches Federgras=>Stipa capillata
Grauscheidiges Federgras=>Stipa eriocaulis
Gelbscheidiges Federgras=>Stipa pennata
Roßschweif-Federgras=>Stipa pulcherrima
Krebsschere=>Stipa tirsa
Stängelumfassender Knotenfuß=>Stratiotes aloides
Pfriemenkresse=>Streptopus amplexifolius
Gewöhnlicher Teufelsabbiss=>Subularia aquatica
Östlicher Sumpfabbiss=>Succisa pratensis
Blauer Sumpfstern=>Succisella inflexa
Gewöhnliche Schneebeere=>Swertia perennis
Korallenbeere=>Symphoricarpos albus
Rauher Beinwell=>Symphoricarpos orbiculatus
Knollen-Beinwell=>Symphytum asperum
Kleiner Kaukasus-Beinwell=>Symphytum bulbosum
Arznei-Beinwell=>Symphytum grandiflorum
Knoten-Beinwell=>Symphytum officinale
Gewöhnlicher Flieder=>Symphytum tuberosum
Hohe Studentenblume=>Syringa vulgaris
Französische Studentenblume=>Tagetes erecta
Gewürztagetes=>Tagetes patula
Französische Tamariske=>Tagetes tenuifolia
Gewöhnliche Schmerwurz=>Tamarix gallica
Balsam-Wucherblume=>Tamus communis
Straußblütige Wucherblume=>Tanacetum balsamita
Großblättrige Wucherblume=>Tanacetum corymbosum
Partheniumblättrige Wucherblume=>Tanacetum macrophyllum
Mutterkraut, Frauen-Wucherblume=>Tanacetum partheniifolium
Rainfarn, Strahlenlose Wucherblume=>Tanacetum parthenium
Gedrängtlappiger Löwenzahn=>Tanacetum vulgare
Herzblättriger Löwenzahn=>Taraxacum congestolobum
Quellschuppen-Löwenzahn=>Taraxacum cordatifolium
Großblütiger Löwenzahn=>Taraxacum fontanosquameum
Kramer-Löwenzahn=>Taraxacum grandiflorum
Südtiroler Löwenzahn=>Taraxacum krameriense
Oostroms Löwenzahn=>Taraxacum martellense
Zerspaltener Löwenzahn=>Taraxacum oostroomii
Podlechs Löwenzahn=>Taraxacum perfissum
Vielschwänziger Löwenzahn=>Taraxacum podlechianum
Einfarbiger Löwenzahn=>Taraxacum polycercum
Kärntner Löwenzahn=>Taraxacum unicoloratum
Schweizer Löwenzahn=>Taraxacum carinthiacum
Funtenseetauern-Löwenzahn=>Taraxacum helveticum
Gesamtalpen-Löwenzahn=>Taraxacum obitsiense
Parsenner Löwenzahn=>Taraxacum panalpinum
Gestielter Löwenzahn=>Taraxacum parsennense
Schmids Löwenzahn=>Taraxacum petiolulatum
Lieblicher Löwenzahn=>Taraxacum schmidianum
Vetters Löwenzahn=>Taraxacum venustum
Adams Löwenzahn=>Taraxacum vetteri
Raunkiaers Löwenzahn=>Taraxacum adamii
Gelerts Löwenzahn=>Taraxacum duplidentifrons
Nordstedts Löwenzahn=>Taraxacum gelertii
Gesägter Löwenzahn=>Taraxacum nordstedtii
Reichlings Löwenzahn=>Taraxacum prionum
Strohblütiger Löwenzahn=>Taraxacum reichlingii
Tiroler Löwenzahn=>Taraxacum cucullatum
Kurzblütiger Löwenzahn=>Taraxacum tiroliense
Schlanker Löwenzahn=>Taraxacum brachyglossum
Geschlitztblättriger Löwenzahn=>Taraxacum gracillimum
Vielzüngiger Löwenzahn=>Taraxacum lacistophyllum
Rotfrüchtiger Löwenzahn=>Taraxacum multiglossum
Bleigrauer Löwenzahn=>Taraxacum parnassicum
Pflaumenfarbener Löwenzahn=>Taraxacum plumbeum
Geröteter Löwenzahn=>Taraxacum prunicolor
Schonener Löwenzahn=>Taraxacum rubicundum
Spitzlappiger Löwenzahn=>Taraxacum scanicum
Gedrehtlappiger Löwenzahn=>Taraxacum tanyolobum
Seltsamer Löwenzahn=>Taraxacum tortilobum
Orangegelber Löwenzahn=>Taraxacum absurdum
Quell-Löwenzahn=>Taraxacum aurantellum
Pohls Löwenzahn=>Taraxacum fontanicola
Hakenförmiger Löwenzahn=>Taraxacum pohlii
Glanzblättriger Löwenzahn=>Taraxacum hamatiforme
Ergänzender Löwenzahn=>Taraxacum lamprophyllum
Ankerblättriger Löwenzahn=>Taraxacum quadrans
Flachmoor-Löwenzahn=>Taraxacum ancoriferum
Bayerischer Löwenzahn=>Taraxacum austrinum
Gezähnter Löwenzahn=>Taraxacum bavaricum
Friesischer Löwenzahn=>Taraxacum dentatum
Deutscher Löwenzahn=>Taraxacum frisicum
Schöner Sumpf-Löwenzahn=>Taraxacum germanicum
Holländischer Löwenzahn=>Taraxacum heleocharis
Stromtalwiesen-Löwenzahn=>Taraxacum hollandicum
Schafweiden-Löwenzahn=>Taraxacum irrigatum
Unverwechselbarer Löwenzahn=>Taraxacum madidum
Weniglappiger Löwenzahn=>Taraxacum memorabile
Pauckerts Löwenzahn=>Taraxacum paucilobum
Pollichs Löwenzahn=>Taraxacum pauckertianum
Kleinköpfiger Löwenzahn=>Taraxacum pollichii
Stufenblättriger Löwenzahn=>Taraxacum subalpinum
Torf-Löwenzahn=>Taraxacum trilobifolium
Wiener Löwenzahn=>Taraxacum turfosum
Haufenblättriger Löwenzahn=>Taraxacum vindobonense
Gleichlappiger Löwenzahn=>Taraxacum acervatulum
Geflügelter Löwenzahn=>Taraxacum aequilobum
Albertshofers Löwenzahn=>Taraxacum alatum
Hoher Löwenzahn=>Taraxacum albertshoferi
Amphorenblättriger Löwenzahn=>Taraxacum altissimum
Prächtiger Löwenzahn=>Taraxacum amphoraefrons
Hakenlappiger Löwenzahn=>Taraxacum amplum
Ankerblättriger Löwenzahn=>Taraxacum ancistrolobum
Sand-Löwenzahn=>Taraxacum anemoomum
Trotziger Löwenzahn=>Taraxacum arquitenens
Graublättriger Löwenzahn=>Taraxacum atrox
Reizvoller Löwenzahn=>Taraxacum baeckiiforme
Kemptener Löwenzahn=>Taraxacum blanditum
Zusammengedrückter Löwenzahn=>Taraxacum campoduniense
Großlappiger Löwenzahn=>Taraxacum contractum
Blauschuppiger Löwenzahn=>Taraxacum copidophyllum
DeBrays Löwenzahn=>Taraxacum cyanolepis
Veränderlicher Löwenzahn=>Taraxacum debrayi
Weitbuchtiger Löwenzahn=>Taraxacum demotes
Ekmanns Löwenzahn=>Taraxacum diastematicum
Schlanker Löwenzahn=>Taraxacum ekmanii
Ausgezogenlappenförmiger Löwenzahn=>Taraxacum elegantius
Band-Löwenzahn=>Taraxacum exsertiforme
Glitzernder Löwenzahn=>Taraxacum fasciatum
Heidnischer Löwenzahn=>Taraxacum fulgidum
Glaphyrus Löwenzahn=>Taraxacum gentile
Tropfentragender Löwenzahn=>Taraxacum glaphyrum
Leberblättriger Löwenzahn=>Taraxacum guttigestans
Harzer Löwenzahn=>Taraxacum hepaticum
Schrecklicher Löwenzahn=>Taraxacum hercynicum
Hülphers Löwenzahn=>Taraxacum horridifrons
Riesiger Löwenzahn=>Taraxacum huelphersianum
Mittlerer Löwenzahn=>Taraxacum ingens
Vermittelnder Löwenzahn=>Taraxacum intermedium
Karwendel-Löwenzahn=>Taraxacum interveniens
Zerteiltblättriger Löwenzahn=>Taraxacum karwendelense
Zipfelmaul-Löwenzahn=>Taraxacum lacerifolium
Breitherzförmiger Löwenzahn=>Taraxacum laciniosifrons
Zungen-Löwenzahn=>Taraxacum laticordatum
Glänzender Löwenzahn=>Taraxacum linguatum
Gelblicher Löwenzahn=>Taraxacum lucidum
Großblüten-Löwenzahn=>Taraxacum luteolum
Gefleckter Löwenzahn=>Taraxacum macranthoides
Großhändiger Löwenzahn=>Taraxacum maculatum
Schwarzgriffeliger Löwenzahn=>Taraxacum megalocarpum
Stumpflaubiger Löwenzahn=>Taraxacum melanostigma
Weißlichgelber Löwenzahn=>Taraxacum obtusifrons
Ohlsens Löwenzahn=>Taraxacum ochrochlorum
Weniggelappter Löwenzahn=>Taraxacum ohlsenii
Mächtiger Löwenzahn=>Taraxacum oligolobatum
Spitzschnäuziger Löwenzahn=>Taraxacum opulentiforme
Gerüsteter Löwenzahn=>Taraxacum oxyrhinum
Pechschwarzer Löwenzahn=>Taraxacum panoplum
Lederfarbener Löwenzahn=>Taraxacum piceatum
Frühblühender Löwenzahn=>Taraxacum pittochromatum
Lauchgrüner Löwenzahn=>Taraxacum praecox
Falscher verlängerter Löwenzahn=>Taraxacum prasinum
Schönblättriger Löwenzahn=>Taraxacum pseudelongatum
Bläulichblättriger Löwenzahn=>Taraxacum pulchrifolium
Rhätischer Löwenzahn=>Taraxacum quadrangulum
Rotfüßiger Löwenzahn=>Taraxacum rhaeticum
Rötlicher Löwenzahn=>Taraxacum rhodopodum
Umkränzter Löwenzahn=>Taraxacum rutilum
Buchtiger Löwenzahn=>Taraxacum sertatum
Gestaltete Löwenzahn=>Taraxacum sinuatum
Verwandter Edel-Löwenzahn=>Taraxacum staturale
Schwachgefärbter Löwenzahn=>Taraxacum subgentiliforme
Ähnlicher Saxens Löwenzahn=>Taraxacum sublaeticolor
Dreieckiger Löwenzahn=>Taraxacum subsaxenii
Dunkelnder Löwenzahn=>Taraxacum subxanthostigma
Bocksbart-Löwenzahn=>Taraxacum tenebricans
Dicklappiger Löwenzahn=>Taraxacum tragopogon
Kräftiger Löwenzahn=>Taraxacum tumentilobum
Violettstieliger Löwenzahn=>Taraxacum valens
Wiinstedts Löwenzahn=>Taraxacum violaceipetiolatum
Zeloten-Löwenzahn=>Taraxacum wiinstedtii
Europäische Eibe=>Taraxacum zelotes
Kahler Bauernsenf=>Taxus baccata
Telekie, Prächtiges Ochsenauge=>Teesdalia nudicaulis
Falsche Alraunenwurzel=>Telekia speciosa
Krauses Greiskraut=>Tellima grandiflora
Spatelblättriges Greiskraut=>Tephroseris crispa
Steppen-Greiskraut=>Tephroseris helenitis
Schweizer Greiskraut=>Tephroseris integrifolia
Neuseelandspinat=>Tephroseris tenuifolia
Gelbe Spargelerbse=>Tetragonia tetragonoides
Trauben-Gamander=>Tetragonolobus maritimus
Edel-Gamander=>Teucrium botrys
Berg-Gamander=>Teucrium chamaedrys
Zurückgebogener Gamander=>Teucrium montanum
Knoblauch-Gamander=>Teucrium resupinatum
Salbei-Gamander=>Teucrium scordium
Bedornter Gamander=>Teucrium scorodonia
Akeleiblättrige Wiesenraute=>Teucrium spinosum
Gelbe Wiesenraute=>Thalictrum aquilegiifolium
Glänzende Wiesenraute=>Thalictrum flavum
Kleine Wiesenraute=>Thalictrum lucidum
Einfache Wiesenraute=>Thalictrum minus
Sumpffarn=>Thalictrum simplex
Alpen-Leinblatt=>Thelypteris palustris
Bayrisches Leinblatt=>Thesium alpinum
Mittleres Leinblatt=>Thesium bavarum
Wiesen-Leinblatt=>Thesium linophyllon
Schnabelfrüchtiges Leinblatt=>Thesium pyrenaicum
Lauch-Hellerkraut=>Thesium rostratum
Acker-Hellerkraut=>Thlaspi alliaceum
Gebirgs-Hellerkraut=>Thlaspi arvense
Rundblättriges Hellerkraut=>Thlaspi caerulescens
Berg-Hellerkraut=>Thlaspi cepaeifolium
Stängelumfassendes Hellerkraut=>Thlaspi montanum
Abendländischer Lebensbaum=>Thlaspi perfoliatum
Morgenländischer Lebensbaum=>Thuja occidentalis
Kleine Spatzenzunge=>Thuja orientalis
Frühblühender Thymian=>Thymelaea passerina
Arznei-Thymian=>Thymus praecox
Sand-Thymian=>Thymus pulegioides
Echter Thymian=>Thymus serpyllum
Winter-Linde=>Thymus vulgaris
Sommer-Linde=>Tilia cordata
Silber-Linde=>Tilia platyphyllos
Gewöhnliche Simsenlilie=>Tilia tomentosa
Kleine Simsenlilie=>Tofieldia calyculata
Grasnelkenblättriges Habichtskraut=>Tofieldia pusilla
Große Zirmet=>Tolpis staticifolia
Acker-Klettenkerbel=>Tordylium maximum
Gewöhnlicher Klettenkerbel=>Torilis arvensis
Feinblättriger Klettenkerbel=>Torilis japonica
Knotiger Klettenkerbel=>Torilis leptophylla
Gewöhnlicher Alpenrachen=>Torilis nodosa
Virginische Dreimasterblume=>Tozzia alpina
Großer Bocksbart=>Tradescantia virginiana
Haferwurz=>Tragopogon dubius
Wiesen-Bocksbart=>Tragopogon porrifolius
Traubiges Klettengras=>Tragopogon pratensis
Gewöhnliche Wassernuss=>Tragus racemosus
Kugel-Knabenkraut=>Trapa natans
Prächtiger Dünnfarn=>Traunsteinera globosa
Alpen-Haarsimse=>Trichomanes speciosum
Rasen-Haarsimse=>Trichophorum alpinum
Krötenlilie=>Trichophorum cespitosum
Europäischer Siebenstern=>Tricyrtis macropoda
Ägyptischer Klee=>Trientalis europaea
Hügel-Klee=>Trifolium alexandrinum
Schmalblättriger Klee=>Trifolium alpestre
Hasen-Klee=>Trifolium angustifolium
Gold-Klee=>Trifolium arvense
Alpen-Braun-Klee=>Trifolium aureum
Feld-Klee=>Trifolium badium
Kleiner Klee=>Trifolium campestre
Erdbeer-Klee=>Trifolium dubium
Schweden-Klee=>Trifolium fragiferum
Rosenklee=>Trifolium hybridum
Mittlerer Klee=>Trifolium incarnatum
Berg-Klee=>Trifolium medium
Blassgelber Klee=>Trifolium montanum
Ungarischer Klee=>Trifolium ochroleucon
Rot-Klee, Wiesen-Klee=>Trifolium pannonicum
Weiß-Klee=>Trifolium pratense
Persischer Klee=>Trifolium repens
Purpur-Klee=>Trifolium resupinatum
Brauner Klee=>Trifolium rubens
Meer-Klee=>Trifolium spadiceum
Gestreifter Klee=>Trifolium squamosum
Bodenfrüchtiger Klee=>Trifolium striatum
Rasiger Klee=>Trifolium subterraneum
Blasenfrüchtiger Klee=>Trifolium thalii
Strand-Dreizack=>Trifolium vesiculosum
Sumpf-Dreizack=>Triglochin maritimum
Schabziger-Klee=>Triglochin palustre
Bockshorn-Klee=>Trigonella caerulea
Schwert-Klee=>Trigonella foenum-graecum
Blaugrüner Faserschirm=>Trigonella gladiata
Geruchlose Kamille=>Trinia glauca
Brot-Grannenhafer=>Tripleurospermum perforatum
Zweizeiliger Goldhafer=>Trisetaria panicea
Wiesen-Goldhafer=>Trisetum distichophyllum
Ähren-Goldhafer=>Trisetum flavescens
Weichweizen=>Trisetum spicatum
Emmer=>Triticum aestivum
Hartweizen=>Triticum dicoccon
Einkorn=>Triticum durum
Europäische Trollblume=>Triticum monococcum
Große Kapuzinerkresse=>Trollius europaeus
Gartentulpe=>Tropaeolum majus
Wilde Tulpe=>Tulipa gesneriana
Breitblättrige Haftdolde=>Tulipa sylvestris
Schmalblättriger Rohrkolben=>Turgenia latifolia
Breitblättriger Rohrkolben=>Typha angustifolia
Laxmann-Rohrkolben=>Typha latifolia
Zwerg-Rohrkolben=>Typha laxmannii
Shuttleworths Rohrkolben=>Typha minima
Stechginster=>Typha shuttleworthii
Berg-Ulme=>Ulex europaeus
Flatter-Ulme=>Ulmus glabra
Feld-Ulme=>Ulmus laevis
Große Brennnessel=>Ulmus minor
Pillen-Brennnessel=>Urtica dioica
Kleine Brennnessel=>Urtica pilulifera
Mittlerer Wasserschlauch=>Urtica urens
Blassgelber Wasserschlauch=>Utricularia intermedia
Dunkelgelber Wasserschlauch=>Utricularia ochroleuca
Bremis Wasserschlauch=>Utricularia stygia
Kleiner Wasserschlauch=>Utricularia bremii
Verkannter Wasserschlauch=>Utricularia minor
Gewöhnlicher Wasserschlauch=>Utricularia australis
Kuhkraut=>Utricularia vulgaris
Großfrüchtige Moosbeere=>Vaccaria hispanica
Hagerups Moosbeere=>Vaccinium macrocarpon
Gewöhnliche Moosbeere=>Vaccinium hagerupii
Rauschbeere=>Vaccinium oxycoccos
Preiselbeere=>Vaccinium uliginosum
Kleiner Baldrian=>Vaccinium vitis-idaea
Berg-Baldrian=>Valeriana dioica
Echter Arznei-Baldrian=>Valeriana montana
Kriechender Arznei-Baldrian=>Valeriana officinalis
Holunderblättriger Arznei-Baldrian=>Valeriana procurrens
Verschiedenblättriger Arznei-Baldrian=>Valeriana sambucifolia
Schmalblättriger Arznei-Baldrian=>Valeriana versifolia
Felsen-Baldrian=>Valeriana wallrothii
Zwerg-Baldrian=>Valeriana saxatilis
Dreiblättriger Baldrian=>Valeriana supina
Gekielter Feldsalat=>Valeriana tripteris
Kronen-Feldsalat=>Valerianella carinata
Gezähnter Feldsalat=>Valerianella coronata
Wollfrüchtiger Feldsalat=>Valerianella dentata
Gewöhnlicher Feldsalat=>Valerianella eriocarpa
Gefurchter Feldsalat=>Valerianella locusta
Gewöhnliche Wasserschraube=>Valerianella rimosa
Zweifelhafter Grannenhafer=>Vallisneria spiralis
Weißer Germer=>Ventenata dubia
Schaben-Königskerze=>Veratrum album
Österreichische Königskerze=>Verbascum blattaria
Großblütige Königskerze=>Verbascum austriacum
Mehlige Königskerze=>Verbascum densiflorum
Windblumen-Königskerze=>Verbascum lychnitis
Violette Königskerze=>Verbascum phlomoides
Flockige Königskerze=>Verbascum phoeniceum
Prächtige Königskerze=>Verbascum pulverulentum
Kleinblütige Königskerze=>Verbascum speciosum
Argentinisches Eisenkraut=>Verbascum thapsus
Lanzen-Eisenkraut=>Verbena bonariensis
Gewöhnliches Eisenkraut=>Verbena hastata
Steinquendel-Ehrenpreis=>Verbena officinalis
Acker-Ehrenpreis=>Veronica acinifolia
Alpen-Ehrenpreis=>Veronica agrestis
Gauchheil-Ehrenpreis=>Veronica alpina
Schlamm-Ehrenpreis=>Veronica anagallis-aquatica
Blasser Gauchheil-Ehrenpreis=>Veronica anagalloides
Blattloser Ehrenpreis=>Veronica catenata
Feld-Ehrenpreis=>Veronica aphylla
Niederliegender Ehrenpreis=>Veronica arvensis
Großer Ehrenpreis=>Veronica prostrata
Bachbungen-Ehrenpreis=>Veronica teucrium
Gänseblümchen-Ehrenpreis=>Veronica beccabunga
Gamander-Ehrenpreis=>Veronica bellidioides
Faden-Ehrenpreis=>Veronica chamaedrys
Felsen-Ehrenpreis=>Veronica filiformis
Halbstrauch-Ehrenpreis=>Veronica fruticans
Efeu-Ehrenpreis=>Veronica fruticulosa
Berg-Ehrenpreis=>Veronica hederifolia
Wald-Ehrenpreis=>Veronica montana
Glanzloser Ehrenpreis=>Veronica officinalis
Fremder Ehrenpreis=>Veronica opaca
Glänzender Ehrenpreis=>Veronica peregrina
Früher Ehrenpreis=>Veronica polita
Schild-Ehrenpreis=>Veronica praecox
Quendel-Ehrenpreis=>Veronica scutellata
Dreiteiliger Ehrenpreis=>Veronica serpyllifolia
Nesselblättriger Ehrenpreis=>Veronica triphyllos
Heide-Ehrenpreis=>Veronica urticifolia
Frühlings-Ehrenpreis=>Veronica dillenii
Wolliger Schneeball=>Veronica verna
Gewöhnlicher Schneeball=>Viburnum lantana
Runzelblättriger Schneeball=>Viburnum opulus
Bithynische Wicke=>Viburnum rhytidophyllum
Kassuben-Wicke=>Vicia bithynica
Gewöhnliche Vogel-Wicke=>Vicia cassubica
Dalmatinische Vogel-Wicke=>Vicia cracca
Feinblättrige Vogel-Wicke=>Vicia dalmatica
Hecken-Wicke=>Vicia tenuifolia
Linsen-Wicke=>Vicia dumetorum
Ackerbohne=>Vicia ervilia
Großblütige Wicke=>Vicia faba
Behaarte Wicke=>Vicia grandiflora
Maus-Wicke=>Vicia hirsuta
Platterbsen-Wicke=>Vicia johannis
Gelbe Wicke=>Vicia lathyroides
Schwarzkopf-Wicke=>Vicia lutea
Walderbsen-Wicke=>Vicia melanops
Heide-Wicke=>Vicia oroboides
Ungarische Wicke=>Vicia orobus
Erbsen-Wicke=>Vicia pannonica
Schmalblättrige Futter-Wicke=>Vicia pisiformis
Herzblättrige Wicke=>Vicia angustifolia
Gewöhnliche Futter-Wicke=>Vicia cordata
Zaun-Wicke=>Vicia sativa
Wald-Wicke=>Vicia sepium
Zierliche Wicke=>Vicia sylvatica
Viersamige Wicke=>Vicia parviflora
Zottige Wicke=>Vicia tetrasperma
Großes Immergrün=>Vicia villosa
Kleines Immergrün=>Vinca major
Weißes Veilchen=>Vinca minor
Zweiblütiges Veilchen=>Viola alba
Gesporntes Stiefmütterchen, Gesporntes Veilchen=>Viola biflora
Hunds-Veilchen=>Viola calcarata
Hügel-Veilchen=>Viola canina
Horn-Veilchen=>Viola collina
Hohes Veilchen=>Viola cornuta
Rauhhaariges Veilchen=>Viola elatior
Wunder-Veilchen=>Viola hirta
Sumpf-Veilchen=>Viola mirabilis
Gräben-Veilchen=>Viola palustris
Niedriges Veilchen=>Viola persicifolia
Pyrenäen-Veilchen=>Viola pumila
Wald-Veilchen=>Viola pyrenaica
Hain-Veilchen=>Viola reichenbachiana
Sand-Veilchen=>Viola riviniana
Blaues Veilchen=>Viola rupestris
Acker-Stiefmütterchen, Acker-Veilchen=>Viola suavis
Wildes Stiefmütterchen=>Viola arvensis
Moor-Veilchen=>Viola tricolor
Stiefmütterchen=>Viola uliginosa
Mistel=>Viola wittrockiana
Weinrebe=>Viscum album
Trespen-Federschwingel=>Vitis vinifera
Bewimperter Federschwingel=>Vulpia bromoides
Mäuseschwanz-Federschwingel=>Vulpia ciliata
Golderdbeere=>Vulpia myuros
Gestielter Kronenlattich=>Waldsteinia geoides
Wurzellose Zwergwasserlinse=>Willemetia stipitata
Alpen-Wimperfarn=>Wolffia arrhiza
Südlicher Wimperfarn=>Woodsia alpina
Zierlicher Wimperfarn=>Woodsia ilvensis
Ufer-Spitzklette=>Woodsia pulchella
Großfrüchtige Spitzklette=>Xanthium albinum
Dornige Spitzklette=>Xanthium orientale
Gewöhnliche Spitzklette=>Xanthium spinosum
Einjährige Spreublume=>Xanthium strumarium
Schmalköpfige Spreublume=>Xeranthemum annuum
Palmlilie=>Xeranthemum cylindraceum
Teichfaden=>Yucca filamentosa
Saat-Mais=>Zannichellia palustris
Girgensohns Torfmoos=>Zea mays
Waldhaarmützenmoos=>Sphagnum girgensohnii
Schneetälchen-Haarmützenmoos=>Polytrichum formosum
Großes Haarmützenmoos=>Polytrichum sexangulare
Glashaar-Haarmützenmoos=>Polytrichum commune
Braunfilziges Haarmützenmoos=>Polytrichum piliferum
Weißfilziges Haarmützenmoos=>Polytrichum juniperinum
Gemeines Weißmoos=>Polytrichum strictum
Vielfrüchtiges Hundszahnmoos=>Leucobryum glaucum
Haar-Drehzahn=>Cynodontium polycarpum
Zartgrünes Perlmoos=>Tortula crinita
Polster-Kissenmoos=>Weissia controversa
Macouns Racomitrium Moos=>Grimmia pulvinata
Becherfrüchtiges Goldhaarmoos=>Racomitrium macounii
Wechselzweigmoos=>Orthotrichum cupulatum
Kriechendes Stumpfdeckelmoos=>Heterocladium heteropterum
Zypressen-Schlafmoos=>Amblystegium serpens
=>Hypnum cupressiforme
Säulenflechte=>Bacidina arnoldiana
=>Cladonia cenotea
Hundsflechte=>Leptogium subtile
Neonflechte=>Peltigera canina
Gewöhnliche Bartflechte=>Psilolechia lucida
Baumartige Wolfsmilch=>Usnea filipendula
Nickender Sauerklee=>Euphorbia dendroides
Einjähriges Gänseblümchen=>Oxalis pes-caprae
Kanarische Dattel-Palme=>Bellis annua
Geißkleeartiger Hornklee=>Phoenix canariensis
Gespenst-Gelbdolde=>Lotus cytisoides
Graue Palmlilie=>Smyrnium olusatrum
Amerikanische Agave=>Yucca aloifolia
Baum-Aloe=>Agave americana
Ästiger Affodill=>Aloe arborescens
Mastorchis, Riesenknabenkraut=>Asphodelus ramosus
Mandarine=>Barlia robertiana
Orange=>Citrus reticulata
Zitrone=>Citrus sinensis
Japanischer Palmfarn=>Citrus x limon
Kanarischer Drachenbaum=>Cycas revoluta
Algiersalat=>Dracaena draco
Birkenfeige=>Fedia cornucopiae
Australischer Gummibaum=>Ficus benjamina
Milchfleckdistel=>Ficus macrophylla
Echter Ölbaum=>Galactites tomentosa
Feigenkaktus=>Olea europaea
Tränen-Kiefer=>Opuntia ficus-indica
Rosmarin=>Pinus wallichiana
Goldkelch-Wein=>Rosmarinus officinalis
Hanfpalme=>Solandra maxima
Kaki-Baum=>Trachycarpus fortunei
Gemeiner Augentrost=>Diospyros kaki
Tomate=>Euphrasia rostkoviana
Graue Gliedermelde=>Solanum lycopersicum
Mittagsblume=>Arthrocnemum glaucum
Trichternarzisse=>Carpobrotus edulis
Korsische Nieswurz=>Pancratium illyricum
Silber-Akazie=>Helleborus lividus
Dorniger Wundklee=>Acacia dealbata
Graubehaarte Zistrose=>Anthyllis hermanniae
Gelbe Zistrose=>Cistus incanus
Blaue Passionsblume=>Halimium halimifolium
Granatapfel=>Passiflora caerulea
Flaum-Eiche=>Punica granatum
Brombeere=>Quercus pubescens
Bergraute=>Rubus fruticosus
Berg-Hauswurz=>Ruta montana
Hängendes Nabelkraut=>Sempervivum montanum
Langähriges Knabenkraut=>Umbilicus rupestris
Bertolonis Ragwurz=>Dactylorhiza saccifera
Schmetterlings-Knabenkraut=>Ophrys bertolonii
Istrischer Zungenstendel=>Orchis papilionacea
Zungenstendel=>Serapias istriaca
Baum-Orchidee=>Serapias vomeracea
Dünen-Zypergras=>Tridactyle bicaudata
Dinkel=>Cyperus capitatus
Tee=>Triticum spelta
Kokospalme=>Camellia sinensis
Guave=>Cocos nucifera
Schirm-Akazie=>Psidium guajava
Seyal-Akazie=>Acacia abyssinica
Schirmakazie=>Acacia seyal
Papierblume=>Acacia tortilis
Kandelaber-Wolfsmilch=>Bougainvillea glabra
Weihnachtsstern=>Euphorbia candelabrum
Kilimandscharo-Gladiole=>Euphorbia pulcherrima
Hardwickia- Balsambaum, Anjan=>Gladiolus watsonioides
Ostindische Hanfrose, Kenaf=>Hardwickia binata
Roseneibisch=>Hibiscus cannabinus
Palisanderholzbaum=>Hibiscus rosa-sinensis
Wandelröschen=>Jacaranda mimosifolia
Löwenohr=>Lantana camara
Köstliches Fensterblatt=>Leonotis ocymifolia
Banane=>Monstera deliciosa
Breitblättrige Steineibe=>Musa acuminata x balbisiana
Kaprose=>Podocarpus latifolius
Johnstons Greiskraut=>Protea madiensis
Mt. Kenya-Greiskraut=>Senecio johnstonii
Afrikanischer Tulpenbaum=>Senecio keniensis
Schwarzäugige Susanne=>Spathodea campanulata
Mexikanische Sonnenblume=>Thunbergia alata
Krallenliane=>Tithonia diversifolia
Hortensien-Schneeball=>Toddalia asiatica
Rotfußröhrling=>Viburnum furcatum
Echter Hausschwamm=>Xerocomellus chrysenteron
Zweizeilige Gerste=>Serpula lacrymans
Luzerne=>Hordeum distichon
Rotgestreifte Nachtkerze=>Medicago sativa
lilac penstemon, Zierlicher Bartfaden=>Oenothera erythrosepala